阿瑟=亞瑟
艾琳=愛琳
安河=安省
肮脏=骯髒
巴利=巴厘
罢休=甘休
办厂=開工廠
班吉=班基
棒冰=冰棒
苞谷=包穀
报账=報帳
贝宁=貝南
奔驰=賓士
比绍=比索
标尺=尺規
饼图=圓形圖
博德=博多
菠萝=鳳梨
布尔=布林
补码=補數
布什=布希
惨淡=慘澹
插件=外掛程式
查账=查帳
倡导=宣導
猖狂=倡狂
超威=超微
程控=程式控制
程序=程式
橙子=柳丁
冲账=沖帳
筹划=籌畫
串行=串列
窗体=表單
磁道=磁軌
磁盘=磁片
词组=片語
答复=答覆
打印=列印
戴维=大衛
丹顿=丹唐
倒霉=倒楣
迪福=狄福
递归=遞迴
迪伦=狄倫
底纹=網底
迭代=反覆運算
断点=中斷點
队列=佇列
多哈=杜哈
发榜=放榜
梵高=梵古
非门=反閘
复核=覆核
复命=覆命
复议=覆議
付账=付帳
戛纳=坎城
格伦=葛籣
公历=西曆
公钥=公開金鑰
光盘=光碟
过账=過帳
哈希=雜湊
海碗=大碗公
汉卡=中文卡
航天=航太
合家=闔家
黑客=駭客
后缀=尾碼
花账=花帳
还账=還帳
回调=回檔
混账=混帳
或门=或閘
基德=吉德
激光=鐳射
借口=藉口
吉士=起士
机箱=主機殼
记账=記帳
家具=傢俱
加纳=迦納
降序=降冪
交账=交帳
借故=藉故
界面=介面
结账=結帳
警察=員警
句柄=控制碼
剧目=劇碼
巨资=鉅資
卡西=凱西
凯南=肯南
康德=康得
可可=可哥
科里=寇里
控件=控制項
快餐=速食
括号=括弧
莱尔=賴爾
赖账=賴帳
劳拉=蘿拉
例程=常式
粒度=細微性
里根=雷根
利落=俐落
利兹=里茲
了解=瞭解
林赛=琳賽
浏览=流覽
鲁昂=盧昂
录像=錄影
洛兰=洛倫
马辰=班格爾馬辛
马洛=馬婁
买账=買帳
门坎=門檻
秘籍=秘笈
密钥=金鑰
秒表=碼錶
明了=明瞭
墨盒=墨水匣
模块=模組
莫奈=莫内
穆尔=莫爾
奶酪=乳酪
南希=南茜
内森=南森
尼罗=尼祿
帕克=派克
爬犁=扒犁
盘片=碟片
盘账=盤帳
赔账=賠帳
屏蔽=遮罩
凭借=憑藉
钱宁=強尼
欠账=欠帳
墙报=壁報
乔布=約伯
清账=清帳
全角=全形
权限=許可權
认账=認帳
入账=入帳
软盘=軟碟
瑞安=里安
萨那=沙那
色拉=沙拉
闪存=快閃記憶體
扇区=磁區
伤员=傷患
赊账=賒帳
沈阳=瀋陽
声卡=音效卡
升序=昇冪
视盘=視訊光碟
实时=即時
鼠标=滑鼠
竖线=分隔號
双击=按兩下
水平=水準
水印=浮水印
瞬时=暫態
私钥=私密金鑰
松元=松本
速溶=即溶
算法=演算法
算账=算帳
汤加=東加
逃课=蹺課
逃学=翹課
铁链=鐵鍊
托德=陶德
脱机=離線
脱氧=去氧
网关=閘道
网络=網路
网桥=橋接器
维基=維琪
位图=點陣圖
尾注=章節附註
温迪=溫蒂
西泽=凱撒
线程=執行緒
项链=項鍊
像素=圖元
想象=想像
肖邦=蕭邦
小区=社區
销账=銷帳
卸除=卸載
辛迪=辛蒂
新山=柔佛巴魯
雪莉=雪麗
循环=迴圈
寻址=定址
哑剧=默劇
要挟=要脅
异步=非同步
以太=乙太
因子=因數
硬件=硬體
硬盘=硬碟
营销=行銷
与门=及閘
域名=功能變數名稱
元音=母音
在线=線上
噪声=雜訊
乍得=查德
站台=月臺
账本=帳本
账册=帳冊
账房=帳房
账户=帳戶
账面=帳面
只读=唯讀
中介=仲介
主板=主機板
朱迪=裘蒂
猪倌=豬官
转账=轉帳
字段=欄位
字号=字型大小
字节=位元組
总线=匯流排
坐标=座標
左证=佐證
超集=超集合
巨港=巴領旁
科罗=柯洛
连手=聯手
玛吉=瑪姬
瑙鲁=諾魯
廷布=辛布
兆位=百萬位元
巴洛=巴羅
半角=半形
屏退=摒退
博格=柏格
带宽=頻寬
单击=按一下
抵账=抵帳
堆栈=堆疊
多拉=朵拉
共享=共用
光驱=光碟機
哈维=哈威
汉纳=漢娜
黑账=黑帳
回放=重播
火并=火拼
计划=計畫
贾森=傑生
脚注=註腳
巨款=鉅款
巨子=鉅子
科拉=柯拉
宽带=寬頻
拉链=拉鍊
烂账=爛帳
联机=連線
令牌=權杖
马尔=瑪律
内存=記憶體
帕劳=帛琉
屏幕=螢幕
前缀=首碼
琼斯=鐘斯
全局=全域
软件=軟體
沙盒=沙箱
上账=上帳
数组=陣列
死锁=鎖死
塑料=塑膠
酸奶=優酪乳
外围=週邊
网民=線民
文莱=汶萊
细账=細帳
小账=小帳
芯片=晶片
也门=葉門
荧光=螢光
荧屏=螢屏
跃层=樓中樓
账簿=帳簿
账号=帳號
账目=帳目
字符=字元
字库=字形檔
总账=總帳
佐拉=左拉
科钦=柯欽
联署=連署
拿骚=拿索
阿比让=阿必尚
阿尔泰=阿勒泰
埃德加=愛德格
艾莉森=愛麗森
敖德萨=奧德薩
奥委会=奧會
卑尔根=貝根
本州岛=本州
便携式=可擕式
表示法=標記法
伯尔尼=伯恩
波特率=串列傳輸速率
菜单项=功能表項目
参考线=輔助線
操作数=運算元
程序员=程式師
抽象类=抽象類別
传感器=感測器
达喀尔=達卡
丹尼斯=鄧尼斯
第三方=協力廠商
迪斯尼=迪士尼
订书机=釘書機
多任务=多工
二进制=二進位
发件箱=寄件匣
菲利普=菲力浦
分布式=分散式
复选框=核取方塊
格雷格=葛列格
公文包=公事包
关系型=關聯式
滚动条=捲軸
核物理=核子物理
宏定义=巨集定義
互操作=交互操作
绘图仪=繪圖器
吉布提=吉布地
激光束=雷射光束
杰奎琳=賈桂琳
金沙萨=金夏沙
晶体管=電晶體
卡塔尔=卡達
堪培拉=坎培拉
可视化=視覺化
来复线=來福線
冷启动=冷開機
利隆圭=里朗威
利雅得=利雅德
联系人=連絡人
刘易斯=路易斯
路易斯=路易士
罗纳德=羅奈爾得
马拉维=馬拉威
麦迪逊=麥迪森
密歇根=密西根
莫扎特=莫札特
尼克松=尼克森
乔伊斯=喬伊絲
轻量级=羽量級
任务栏=工作列
撒切尔=柴契爾
塞缪尔=撒母耳
圣迭戈=聖達戈
时间戳=時間戳記
实例化=產生實體
数据表=資料表
数据块=資料塊
数据域=資料欄
树形图=樹狀圖
死循环=閉環
讨论组=討論群組
条形图=橫條圖
吞吐量=輸送量
网格线=格線
维罗索=維羅梭
文档库=文件庫
文件名=檔案名
西红柿=番茄
消息框=訊息方塊
新西兰=紐西蘭
虚拟盘=虛擬碟
雅各布=雅各
雅温得=雅恩德
阎王账=閻王帳
易拉罐=易開罐
源代码=原始程式碼
源文档=來源文件
赞比亚=尚比亞
制表位=定位停駐點
智能型=智慧型
朱丽叶=茱麗葉
专用网=私人網路
自变量=引數
字符串=字串
组合键=複合鍵
布朗宁=白朗寧
丹吉尔=坦吉爾
顶刮刮=頂呱呱
弗洛拉=芙羅拉
宏语言=巨集語言
贾斯廷=札斯廷
九九表=九九乘法表
卡诺图=坎諾圖
坎大哈=坎達哈
留尼汪=留尼旺
路易港=路易士港
罗得岛=羅德島
麦纳麦=麥納瑪
门德尔=孟德爾
塔米卡=泰咪卡
退格符=後退字元
虚通道=虛擬通道
溢出区=溢位區域
源语言=來源語言
活动文件=使用中的檔案
计划数字=計畫數位
交互方式=對話模式
解除分配=解除配置
空地导弹=空對地導彈
空闲时间=閒置時間
逻辑文件=邏輯檔
密执安州=密西根州
莫雷利亚=莫雷里亞
目标程序=目的程式
内部对象=內建物件
匿名登录=匿名登入
普雷斯顿=普勒斯頓
塞安德尔=塞安得爾
圣多明各=聖多明哥
圣皮埃尔=聖皮爾
数据保护=資料保護
数据共享=資料共用
数据链路=資料連結
数据信号=資料信號
数字对象=數位物件
数字输出=數位輸出
顺序文件=順序檔
算术运算=算數運算
图文电视=電傳視訊
网络地址=網路位址
文件备份=檔案備份
文件句柄=檔案控制代碼
项目评估=專案評估
项目预算=專案預算
协议规范=協定規範
协议转换=協定轉換
验收测试=接受度測試
异步操作=非同步作業
用户代理=使用者代理
源服务器=原始伺服器
支持软件=支援軟體
支持组织=支援組織
智能代理=智慧代理
专门项目=專門專案
阿伯丁=亞伯丁
阿布贾=阿布加
阿加莎=愛葛莎
阿曼达=艾曼達
艾伯特=亞伯特
埃德蒙=艾德蒙
埃尔顿=愛爾頓
艾萨克=以撒
安德烈=安德列
安全组=安全性群組
奥斯汀=奧斯丁
八音盒=音樂盒
白噪声=白色雜訊
班珠尔=班竹
鲍里斯=伯里斯
贝弗利=貝芙麗
本地化=當地語系化
毕加索=畢卡索
编辑框=編輯方塊
表达式=運算式
表示层=展示層
标识符=識別字
标识列=識別欄位
冰淇淋=霜淇淋
播放器=播放機
伯明翰=伯明罕
布莱尔=布雷爾
菜单栏=功能表列
采样率=取樣速率
操作表=動作表
查尔斯=查理斯
查看器=檢視器
超文本=超文字
程序包=套裝程式
城域网=都會區網路
冲浪者=飆網者
触摸板=觸控板
出租车=計程車
纯文本=純文字
达标率=達成率
大甩卖=大拍賣
打印机=印表機
代码段=程式碼片段
单精度=單精確度
单元格=儲存格
导航栏=巡覽列
邓普西=鄧蒲賽
迪金森=迪金遜
迪斯科=迪斯可
地址池=位址集區
电饭锅=電鍋
定时器=計時器
杜尚别=杜桑貝
对话框=對話方塊
多丽丝=桃莉絲
多音字=破音字
二极管=二極體
发件人=寄件者
发行版=發行版本
番石榴=芭樂
反斜杠=反斜線
方便面=速食麵
防伪码=防虛擬碼
分辨率=解析度
分隔符=分隔符號
分类账=分類帳
佛得角=維德角
服务器=伺服器
复印机=影印機
冈比亚=甘比亞
供货商=供應商
工具栏=工具列
关键词=關鍵字
广告牌=看板
广域网=廣域網路
过滤器=篩檢程式
哈罗德=哈樂德
海参崴=符拉迪沃斯托克
函数库=函式程式庫
航天员=太空人
核试验=核子試驗
宏病毒=巨集病毒
宏命令=巨集命令
候机楼=候機室
户口簿=戶口名簿
华尔兹=華爾滋
换行符=分行符號
惠灵顿=威靈頓
回形针=迴紋針
活页夹=文件夾
基地址=基底位址
激光器=雷射器
吉隆坡=吉隆玻
计算机=電腦
交互式=互動式
杰斐逊=傑弗遜
杰里米=傑瑞米
杰西卡=潔西嘉
静态库=靜態程式庫
旧金山=三藩市
九州岛=九州
均衡器=等化器
卡尔文=喀爾文
卡米拉=卡蜜拉
凯瑟琳=凱薩琳
柯蒂斯=柯帝士
克莱尔=克雷爾
科伦坡=可倫坡
肯尼迪=甘迺迪
空格键=空白鍵
快捷键=快速鍵
扩展名=副檔名
拉拉队=啦啦隊
来复枪=來福槍
莱索托=賴索托
雷诺阿=雷諾瓦
丽贝卡=麗蓓嘉
莉迪亚=莉蒂亞
立体声=身歷聲
连接符=連接子
连接性=連線性
连字符=連字號
流水账=流水帳
卢萨卡=路沙卡
录音机=答錄機
落基山=洛磯山
吕贝克=盧貝克
马耳他=馬爾他
马六甲=麻六甲
麦地那=麥迪那
麦克白=馬克白
米歇尔=蜜雪兒
命令行=命令列
默认值=預設值
目标机=目的機
慕尼黑=慕尼克
内罗毕=奈洛比
纽瓦克=紐華克
诺曼底=諾曼第
胖大海=膨大海
批处理=批次處理
批作业=批次工作
普拉亚=培亞
启动盘=開機磁片
潜水员=潛水夫
乔安娜=瓊安娜
切斯特=賈斯特
丘吉尔=邱吉爾
热启动=暖開機
日耳曼=日爾曼
软件包=套裝軟體
撒丁岛=薩丁島
塞勒姆=賽勒姆
塞舌尔=塞席爾
桑巴舞=森巴舞
扫描仪=掃描器
圣诞节=耶誕節
圣何塞=聖約瑟
史丹利=史坦萊
十进制=十進位
视频卡=視訊卡
收款机=收銀機
数据报=資料包
数据段=資料段
数据库=資料庫
数据链=資料鏈
数据项=資料項目
数据源=資料來源
属性表=屬性工作表
数字化=數位化
斯大林=史達林
搜索页=搜尋網頁
随机数=亂數
套接字=通訊端
特拉华=德拉瓦
条形码=條碼
通配符=萬用字元
头文件=標頭檔
退格键=倒退鍵
托马斯=湯瑪斯
瓦杜兹=瓦都茲
微机室=微電腦室
威士忌=威士卡
韦斯利=衛斯理
文本框=文字方塊
文件夹=資料夾
沃里克=瓦立克
物理层=實體層
西奥多=希歐多爾
希拉里=希拉蕊
系统盘=系統磁片
现金账=現金帳
显示屏=顯示幕
小两口=小倆口
写保护=防寫
新闻组=新聞群組
信息论=資訊理論
休斯敦=休士頓
虚拟机=虛擬機器
雅尔塔=雅爾達
压缩盘=壓縮磁碟
演示版=展示版本
羊痫风=羊癲瘋
意大利=義大利
伊犁河=伊黎河
因特网=網際網路
幼儿园=幼稚園
优先级=優先順序
与非门=反及閘
源程序=來源程式
元数据=中繼資料
源文件=原始檔案
约翰逊=詹森
运算符=運算子
噪声源=噪音源
扎伊尔=薩伊
占位符=預留位置
珍妮弗=珍妮佛
帧中继=框架轉送
制表符=定位字元
直方图=長條圖
只基金=檔基金
智能卡=智慧卡
中间件=中介軟體
主分区=主要磁碟分割
主机名=主機名稱
柱形图=直條圖
转折点=轉捩點
桌面版=桌上出版
子菜单=子功能表
自定义=自訂
组策略=群組原則
组合框=下拉式列示方塊
巴比隆=巴比靈斯
博伊尔=波義耳
布赖顿=布里奇頓
补码器=互補器
除莠剂=除銹劑
黛安娜=戴安娜
帝力巴=帝利巴
弗里敦=自由城
格罗索=格羅梭
宏业宏=巨集業巨集
宏指令=巨集指令
缓冲池=緩衝集區
会话层=工作階段層
或非门=反或閘
激光盘=雷射盤
贾里德=傑瑞德
假脱机=周邊同作
纠错码=改錯碼
菊花链=菊輪鍊
卡罗琳=卡洛琳
卡斯珀=卡斯帕
可擦写=可讀寫
空格符=空白字元
雷切尔=瑞吉兒
刘宏宏=劉巨集巨集
录放机=錄放影機
伦道夫=藍道夫
马那瓜=馬納瓜
美因河=緬因河
门阵列=閘陣列
米尔顿=密爾頓
纳塔利=娜特莉
努美阿=諾美亞
帕皮提=帕比提
乔治敦=喬治城
实地址=真實位址
搜索树=搜尋樹
索非亚=索菲亞
陶朗阿=陶朗阿加
图瓦卢=吐瓦魯
瓦莱塔=瓦勒他
王宏宏=王巨集巨集
韦尔斯=威爾斯
维斯比=維斯堡
伪指令=虛擬指令
乌伊拉=威拉
虚参数=虛設參數
虚呼叫=虛擬呼叫
旋光性=光性
亚拉腊=阿拉臘
页表项=分頁表項目
硬设备=硬體設備
源目录=原始目錄
元文件=中繼檔
泽维尔=賽維爾
帧格式=框架格式
证书链=憑證連結
字处理=文書處理
阿布扎比=阿布達比
阿塞拜疆=亞塞拜然
阿雅克肖=阿雅丘
爱憎分明=愛恨分明
巴巴多斯=巴貝多
巴塞罗那=巴賽隆納
奔走相告=奔相走告
比什凯克=比斯凱克
博茨瓦纳=波札那
玻利瓦尔=玻利瓦爾省
布拉德利=布蘭得利
参考数据=參考資料
操作系统=作業系統
程序代码=程式碼
处理程序=處理常式
传输数据=傳輸資料
磁盘阵列=磁碟陣列
存储设备=存放裝置
打印预览=預覽列印
道听途说=道聼塗説
点击链接=點選連結
电子表格=試算表
电子数据=電子資料
多米尼加=多明尼加
二进制数=二進位數字
访问权限=存取權限
菲尼克斯=費尼克斯
佛罗伦萨=佛羅倫斯
福尔马林=福馬林
弗吉尼亚=維吉尼亞
富兰克林=佛蘭克林
弗洛伊德=佛洛德
复位电路=重定電路
服务项目=服務專案
高级语言=高階語言
格林纳达=格瑞那達
攻城略地=攻城掠地
勾股定理=畢氏定理
过程控制=程序控制
过眼烟云=過眼雲煙
汉语拼音=中文拼音
核反应堆=核反應爐
赫鲁晓夫=赫魯雪夫
宏昌电子=巨集昌電子
后台程序=幕後程式
汇编语言=組合語言
霍格沃茨=霍格華茲
即插即用=隨插即用
基础数据=基礎資料
吉尔伯特=吉伯特
基金项目=基金專案
技术支持=技術支援
加拉加斯=卡拉卡斯
介绍对象=介紹物件
局部变量=區域變數
具体地址=具體位址
卡斯特罗=卡斯楚
开卷有益=開券有益
康涅狄格=康乃狄克
克里斯蒂=克利斯蒂
克什米尔=喀什米爾
可移植性=可攜性
宽带连接=寬頻連線
利比里亚=賴比瑞亞
连接超时=連接逾時
了如指掌=瞭若指掌
临时文件=暫存檔案
马尔代夫=馬爾地夫
马克西姆=馬克沁
毛里求斯=模里西斯
孟加拉国=孟加拉
面向对象=物件導向
摩尔多瓦=莫爾達瓦
默认网关=預設閘道器
尼日利亚=奈及利亞
帕特里克=派翠克
配置文件=設定檔
屏幕保护=螢幕保護裝置
签订协议=簽訂協定
人工智能=人工智慧
软件开发=軟體發展
萨格勒布=札格雷布
塞拉利昂=獅子山
塞万提斯=賽凡提斯
桑给巴尔=桑吉巴
圣彼得堡=聖彼德堡
圣地亚哥=聖地牙哥
圣马力诺=聖馬利諾
市场信息=市場訊息
施工项目=施工專案
十六进制=十六進位
视频会议=視訊會議
事务处理=交易處理
收费项目=收費專案
数据备份=資料備份
数据仓库=資料倉庫
数据传输=資料傳輸
数据管理=資料管理
数据结构=資料結構
数据类型=資料類型
数据模型=資料模型
数据通信=資料通信
数据网络=資料網路
数据文件=資料檔案
数据质量=資料品質
数据字典=資料字典
输入数据=輸入資料
数字电路=數位電路
数字控制=數位控制
数字密码=數位密碼
数字图像=數位圖像
数字信号=數位信號
斯威士兰=史瓦濟蘭
搜索引擎=搜尋引擎
弹出窗口=快顯視窗
坦桑尼亚=坦尚尼亞
提供数据=提供資料
通讯地址=通訊位址
图像处理=影像處理
玩忽职守=怠忽職守
危地马拉=瓜地馬拉
未能免俗=不能免俗
文本文件=文字檔
文件格式=檔案格式
文件类型=檔案類型
文件系统=檔案系統
我的文档=我的文件
乌得勒支=烏德勒支
物理内存=實體記憶體
无线通信=無線通訊
西北地区=西北地方
系统配置=系統組態
下拉菜单=下拉式功能表
下载文件=下載檔案
项目编码=專案編碼
项目管理=專案管理
项目进度=專案進度
项目经理=專案經理
项目申报=專案申報
项目现场=專案現場
项目验收=專案驗收
销售支持=銷售支援
协议存款=協定存款
辛丑条约=辛丑合約
虚拟现实=虛擬實境
压缩文件=壓縮檔
研究对象=研究物件
羊肠小道=羊腸小徑
仰韶文化=仰紹文化
移动电话=行動電話
倚老卖老=以老賣老
伊丽莎白=伊莉莎白
印第安纳=印第安那
用户密码=使用者密碼
幼儿教育=幼稚教育
邮政编码=郵遞區號
语音识别=語音辨識
宇宙飞船=太空船
运行时间=執行時間
掌上电脑=掌上型電腦
这是地址=這是位址
质量管理=品質管制
智能电视=智慧電視
智能武器=智慧型武器
智能硬件=智慧硬體
智能制造=智慧製造
知识产权=智慧財產權
重大项目=重大專案
自动应答=自動回應
资源分配=資源配置
最新地址=最新位址
巴塞洛缪=巴薩羅繆
保罗索萨=保羅梭薩
贝尔莫潘=貝爾墨邦
贝齐米特=貝琪米特
变更项目=變更專案
编码数据=編碼資料
编译程序=編譯器
表现对象=表現物件
并行操作=平行作業
并行端口=平行埠
并行算法=平行算法
波多诺伏=波多洛
波斯尼亚=波士尼亞
布尔函数=布耳函數
布雷斯特=布列斯特
不伦瑞克=布勞恩斯魏克
串行传输=序列傳輸
串行鼠标=序列滑鼠
存储元件=記憶元件
错误数据=錯誤資料
贷款协议=貸款協定
单步操作=單步作業
单选按钮=選項按鈕
当前目录=目前的目錄
等待状态=等候狀態
低级语言=低階語言
地址空间=位址空間
地址总线=位址匯流排
动态绑定=動態繫結
对象连接=物件連接
对象语言=物件語言
敦刻尔克=敦克爾克
调试程序=偵錯工具
访问控制=存取控制
分组密码=區塊編碼器
符号文件=符號檔
富纳富提=福納佛提
福塔莱萨=福塔雷薩
服务协议=服務協定
改进项目=改進專案
高档商品=高級商品
高速缓存=快取記憶體
格雷戈里=葛列格里
根据协议=根據協定
瓜达卢佩=瓜達羅佩
关系演算=關聯計算法
过程数据=過程資料
函数调用=函式呼叫
宏发化工=巨集發化工
互操作性=互通性
阿迪达斯=愛迪達
阿斯塔纳=阿斯坦納
安全通道=秘密頻道
比较数据=比較資料
标准偏差=標準差
播放列表=播放清單
程序文件=程式檔
措施项目=措施專案
代理协议=代理協定
电子货币=電子錢
电子文件=電子檔
多米尼克=多明尼克
费迪南德=斐迪南
弗朗西斯=法蘭西斯
俯首帖耳=俯首貼耳
服务对象=服務物件
辅助功能=協助工具
哈密尔顿=漢米爾頓
航天飞机=太空梭
河外星系=銀河外星系
呼叫转移=來電轉接
集成电路=積體電路
基里巴斯=吉里巴斯
津巴布韦=辛巴威
具体项目=具體專案
克罗地亚=克羅埃西亞
科特迪瓦=象牙海岸
利伯维尔=自由市
链接地址=連結位址
渺无人烟=杳無人煙
莫桑比克=莫三比克
庞蒂亚克=皮蒂亞克
萨拉热窝=塞拉耶佛
塞浦路斯=賽普勒斯
圣路易斯=聖路易斯
生物武器=生化武器
史蒂文森=史蒂文生
视频地址=視頻位址
视频剪辑=視訊短片
鼠标指针=滑鼠指標
数据采集=資料獲取
数据处理=資料處理
数据接口=資料介面
数据连接=資料連接
数据挖掘=資料採擷
数据维护=資料維護
数据显示=資料顯示
数据中心=資料中心
输入设备=輸入裝置
输入数字=輸入數位
数字电视=數位電視
数字逻辑=數位邏輯
数字签名=數位簽章
数字相机=數位相機
数字证书=數位憑證
体检项目=體檢專案
文件传输=檔案傳輸
文件目录=檔目錄
温切斯特=溫徹斯特
我的主页=我的首頁
物理地址=物理位址
系统文件=系統檔
项目工作=專案工作
项目计划=專案計畫
项目经费=專案經費
项目开发=專案開發
项目实施=專案實施
项目信息=專案資訊
项目执行=專案執行
笑逐颜开=笑顏逐開
协议内容=協定內容
眼观四路=眼觀四面
页面布局=頁面配置
伊斯兰堡=伊斯蘭馬巴德
引火烧身=引火焚身
用户信息=使用者資訊
远程访问=遠端存取
震古烁今=震古鑠今
质量信息=品質資訊
智能交通=智慧交通
智能系统=智慧系統
智能语音=智慧語音
智能终端=智慧終端機
知识分子=知識份子
重点项目=重點專案
子网掩码=子網路遮罩
资源共享=資源分享
备份文件=備份檔案
编解码器=轉碼器
扁平电缆=排線
标准对象=標準物件
并行传输=平行傳輸
并行计算=平行計算
伯恩茅斯=伯恩第斯
布尔运算=布耳運算
不予支持=不予支援
串行端口=序列埠
单处理器=單一處理器
得克萨斯=德克薩斯
登录脚本=登入指令檔
地域类型=地欄位型別
地址掩码=位址遮罩
对象模型=物件模型
对象字典=物件字典
费用项目=費用專案
符号智能=符號智慧
赋值语句=設定陳述式
高对比度=高對比
戈亚斯城=戈阿斯城
关系代数=關聯代數
合作协议=合作協定
胡里胡涂=糊裡糊塗
坏扇区法=損毀的磁區法
汇编程序=組合語言程式
会话密钥=工作階段金鑰
活动分区=使用中的磁碟分割
霍尼亚拉=荷尼阿拉
激光照排=雷射排版
加比隆多=加比靈斯多
交叉汇编=交叉組合
交易协议=交易協定
杰弗里斯=傑佛瑞斯
经常项目=經常專案
静态绑定=靜態繫結
经营数据=經營資料
局部总线=區域匯流排
绝对地址=絕對位址
堪萨斯城=坎薩斯城
科宏化工=科巨集化工
科纳克里=柯那克里
空空导弹=空對空導彈
控制数据=控制資料
库克群岛=科克群島
连接时间=連線時間
逻辑地址=邏輯位址
逻辑设备=邏輯裝置
马拉开波=馬拉凱博
马提尼克=法屬馬丁尼克
曼萨尼约=曼薩尼尤
梅雷迪思=馬里帝茲
密钥证书=金鑰委付
敏感数据=敏感性資料
摩加迪沙=摩加迪休
莫塔米尔=莫泰咪爾
目标对象=目標物件
纳撒尼尔=納旦尼爾
内部函数=內建函式
尼科西亚=尼古西亞
欧里亚克=歐里西克
佩内洛普=潘娜洛普
普埃布拉=布埃布拉
朴次茅斯=樸資茅斯
软件中断=軟體插斷
圣安德尔=聖安得爾
圣卢西亚=聖露西亞
视频模式=視訊模式
数据安全=資料安全
数据抽象=資料抽象
数据格式=資料格式
数据划分=資料劃分
数据检索=資料檢索
数据空间=資料空間
数据目录=資料目錄
数据确认=資料確認
数据属性=資料屬性
数据系统=資料系統
数据压缩=資料壓縮
数据组织=資料組織
数字编码=數位編碼
数字光驱=數位光碟機
数字模拟=數位類比
数字输入=數位輸入
数字字符=數位字元
顺序搜索=循序搜尋
斯蒂法尼=斯蒂芙妮
算法语言=演算語言
唐古拉山=唐古喇山
亭可马里=特亭可馬利
图片用户=圖片使用者
图像文件=影像檔
图形文件=圖形檔
外层空间=外太空
婉转悠扬=宛轉悠揚
温布尔登=溫布頓
文件保护=檔案保護
文件结构=檔結構
文件属性=檔案屬性
文件组织=檔組織
物理信号=實體信號
无损压缩=無失真壓縮
下拉列表=下拉清單
显示文件=顯示檔
项目贷款=專案貸款
项目文件=專案檔案
协处理器=輔助處理器
协议交易=協定交易
协议实体=協定實體
信息协议=資訊協定
虚拟地址=虛擬位址
亚马孙河=亞馬遜河
眼捷手快=眼明手快
衣阿华州=艾奧瓦州
影像数据=影像資料
影像用户=影像使用者
用户程序=使用者程式
用户内存=使用者記憶體
用户选项=使用者選項
有损压缩=失真壓縮
域名系统=網域名稱系統
远程登录=遠端登入
远程终端=遠端終端機
元数据库=中繼資料庫
支持程序=支援程式
支持系统=支援系統
指令周期=運算速度
智能对象=智慧對象
中断请求=插斷要求
中间设备=中繼裝置
主计算机=主機電腦
阿姆斯特朗=阿姆斯壯
艾森豪威尔=艾森豪
贝尔格莱德=貝爾格勒
比勒陀利亚=普利托里亞
布基纳法索=布吉納法索
磁盘驱动器=磁碟機
迪斯尼乐园=狄斯奈樂園
俄克拉荷马=奧克拉荷馬
戈尔巴乔夫=戈巴契夫
哈萨克斯坦=哈薩克
克里斯蒂娜=克莉絲蒂娜
可移动磁盘=抽取式磁碟
路易斯安那=路易斯安那
马萨诸塞州=麻塞諸塞州
普罗米修斯=普羅米修士
任务管理器=工作管理員
设备管理器=裝置管理員
数据透视表=樞紐分析表
斯洛文尼亚=斯洛維尼亞
网络管理员=網路系統管理員
文本编辑器=文字編輯器
项目负责人=專案負責人
亚里士多德=亞里斯多德
印度尼西亚=印尼
针式打印机=點陣式印表機
智能机器人=智慧型機器人
八进制数字=八進位數字
班克罗夫特=班克羅福特
并行计算机=平行電腦
伯罗奔尼撒=伯羅奔尼薩斯
程序支持库=程式支援函式庫
串行打印机=序列式印表機
磁盘控制器=磁碟控制卡
打印服务器=印表伺服器
帝力收三统=帝利收三統
地址寄存器=位址寄存器
动态存储器=動態儲存裝置器
对象标识符=物件識別碼
对象管理组=物件管理組
对象式分析=物件式分析
对象式语言=物件式語言
多用户系统=多使用者系統
弹性支持梁=彈性支援梁
反编译程序=解編程式
反汇编程序=反組譯工具
防病毒程序=防毒程式
仿真信息库=模擬資訊庫
非消费项目=非消費專案
分组交换网=封包交換網
傅立叶变换=傅立葉轉換
辅助存储器=次要存放裝置
敢忘帝力勤=敢忘帝利勤
个人标识号=個人識別碼
耕耘忘帝力=耕耘忘帝利
公用数据网=公用資料網
关系数据库=關聯式資料庫
海量存储器=大量記憶體
汉弗莱氏魮=韓弗理氏魮
恒定比特率=常數位元速率
宏规则天地=巨集規則天地
计算机数据=電腦資料
静态数据区=靜態資料區
卡斯特里港=卡斯翠港
卡斯特里尼=卡斯翠尼
可变比特率=變數位元速率
可执行文件=可執行檔
利马瓦迪联=科馬瓦迪聯
零拷贝协议=零拷貝協定
逻辑驱动器=邏輯磁碟機
马科伦农场=馬科藍儂場
蒙得维的亚=蒙特維多
蒙特塞拉特=蒙瑟拉特島
密码检验和=密碼核對總和
莫尔兹比港=莫爾斯貝港
目标计算机=目的電腦
南罗得西亚=南羅德西亞
努库阿洛法=努瓜婁發
帕拉马里博=巴拉馬利波
平板扫描仪=平台掃描器
软盘驱动器=軟碟機
散乱数据点=散亂資料點
十进制数字=十進位數字字
视频存储器=視訊記憶體
数据和信息=資料和資訊
数据交换机=資料交換機
数据完整性=資料完整性
数字记录器=數位記錄器
数字频率计=數位頻率計
数字照相机=數位照相機
塔那那利佛=安塔那那利佛
图形适配器=圖形卡
威廉斯塔德=維倫斯塔
威斯康星州=威斯康辛州
文件分配表=檔案配置表
文件控制块=檔案控制區
沃伦抽象机=沃倫抽象機器
西里尔戈纳=西瑞爾戈納
下拉列表框=下拉式清單方塊
项目数据库=專案資料庫
信号转换器=訊號轉換器
虚拟局域网=虛擬區域網路
亚拉巴马州=阿拉巴馬州
伊迪丝抟鱼=伊蒂絲摶魚
已见帝力雄=已見帝利雄
移位寄存器=移位暫存器
硬件配置项=硬體設定項
源数据鉴别=來源資料鑒別
指令和数据=指令和資料
智能化工具=智慧化工具
埃塞俄比亚=衣索比亞
笔记本电脑=筆記型電腦
不间断电源=不斷電供應系統
动态链接库=動態連結程式庫
哥斯达黎加=哥斯大黎加
激光打印机=雷射印表機
克里斯托弗=克里斯多夫
马克斯韦尔=麥斯威爾
乞力马扎罗=乞力馬札羅
视频转换器=視訊轉換器
调制解调器=數據機
网络适配器=網路介面卡
项目建议书=專案建議書
伊丽莎白港=伊麗沙伯港
约翰内斯堡=約翰尼斯堡
正则表达式=規則運算式
帝力终何有=帝利終何有
点对点协议=點對點通訊協定
对象的变化=物件的變化
对象式设计=物件式設計
非实时数据=非即時資料
服务访问点=服務存取點
格式化数据=格式化資料
卡斯特里隆=卡斯翠隆
可靠性数据=可靠性資料
马设得兰鰤=馬設德蘭鰤
努瓦克肖特=諾克少
批处理文件=批次檔
普西迪基地=蒲賽迪基地
萨尔布吕肯=索爾布呂肯
视频缓冲区=視訊緩衝區
数字计算机=數位電腦
数字转换器=數位轉換器
文件服务器=檔案伺服器
亚历山德拉=亞歷山卓
智能计算机=智慧電腦
个人数字助理=個人數位助理
卡桑德拉大桥=卡珊多拉大橋
数字媒体技术=數位媒體技術
信息高速公路=資訊公路
包交换数据网=包交換資料網
比哈尔无须魮=比哈爾邦無須魮
产品数据手册=產品資料手冊
单用户计算机=單使用者電腦
电子邮件地址=電子郵寄地址
动态存储管理=動態儲存裝置管理
对象请求代理=物件請求代理
达累斯萨拉姆=沙蘭港
数字电子技术=數位電子技術
亚的斯亚贝巴=阿迪斯阿貝巴
被支持的物体=被支援的物體
布尔日大教堂=布日大教堂
磁盘高速缓存=磁碟快取
大容量存储器=大量存放區
单地址计算机=單位址電腦
地址解析协议=位址解析通訊協定
动态存储分配=動態儲存裝置分配
对象建模技术=物件建模技術
二进制大对象=二進位大物件
符号数字测验=符號數位測驗
公司文件索引=公司檔索引
国营报伦农场=國營報藍儂場
荷属安的列斯=荷屬安替列斯
宏业汽车服务=巨集業汽車服務
击打式打印机=撞擊式印表機
加速图形端口=高速圖形連接埠
结构化编辑器=結構編輯器
军团显示设备=軍團顯示裝置
开放系统互连=開放系統互相連線
空间数据融合=空間資料融合
令牌传递协议=權杖傳遞協定
卢旺达共和国=盧安達共和國
曼斯菲尔德城=曼斯費爾德城
讷韦尔二须鲶=納韋爾二須鯰
窃取信道信息=竊取通道資訊
商业数据交换=商業資料交換
数据操纵语言=資料操縱語言
数据访问路径=資料訪問路徑
数据加密密钥=資料加密金鑰
数字地面模型=數位地面模型
数字卫星通信=數位衛星通信
斯里巴加湾市=斯里百家灣市
统一建模语言=統一模組化語言
图片传输协议=圖片傳輸協定
网络时间协议=網路時間協定
文件管理协议=檔管理協議
现金投入数字=現金投入數位
项目费用管理=專案費用管理
项目沟通管理=專案溝通管理
项目特征曲线=專案特徵曲線
协议数据单元=協定資料單元
循环冗余检验=循環冗餘核對
异常处理程序=例外處理常式
用户定义消息=使用者定義訊息
用户造字程序=使用者造字程式
远程支持设施=遠端支援設施
账外资产项目=賬外資產專案
智能决策系统=智慧決策系統
智能预览功能=智慧預覽功能
主要贸易伙伴=主要交易夥伴
分布式计算机=分散式運算機
宏润商贸服务=巨集潤商貿服務
货币总体数字=貨幣總體數位
开放回购协议=開放回購協定
空间数据内插=空間資料內插
流动资金支持=流動資金支援
论概念和对象=論概念和物件
马里亚纳群岛=馬利安納群島
曼斯菲尔德英=曼斯費爾德英
面向字符协议=面向字元協定
内部网关协议=內部閘道通訊協定
软件经验数据=軟體經驗資料
数据初始加工=資料初始加工
数据高速缓存=資料快取記憶體
数据加密算法=資料加密演算法
数字传输通路=數位傳輸通路
数字摄影技术=數位攝影技術
斯瓦尔巴群岛=冷岸群島
泰罗索斯男爵=泰羅梭斯男爵
通用串行总线=通用序列匯流排
网际协议地址=網際協議位址
文件管理系统=檔管理系統
系统控制文件=系統控制檔
项目反应理论=專案反應理論
项目服务面积=專案服務面積
项目特征函数=專案特徵函數
项目整体管理=專案整體管理
异步过程调用=非同步程序呼叫
用户产权网络=使用者產權網路
用户造词程序=使用者造詞程式
智能磨皮软件=智慧磨皮軟體
智能支持系统=智慧支援系統
转移目标地址=轉移目標位址
布宜诺斯艾利斯=布宜諾賽勒斯
单用户操作系统=單使用者作業系統
分布式对象计算=分散式物件計算
假脱机文件标志=周邊同作檔標誌
局域网广播地址=局域網廣播位址
康塞普西昂大学=康塞蒲賽昂大學
秘密数据存取卡=秘密資料存取卡
数字信号处理器=數位訊號處理器
项目资本金制度=專案資本金制度
用户数据报协议=使用者資料包通訊協定
指令地址计数器=指令位址計數器
综合业务数字网=整合式服務數位網路
巴布亚新几内亚=巴布亞紐幾內亞
搜狗智能输入环=搜狗智慧輸入環
北马里亚纳群岛=北馬里安納群島
大规模集成电路=大型積體電路
地理数据可视化=地理資料視覺化
电子数字积分器=電子數位積分器
对象式程序设计=物件式程式設計
非经常开支项目=非經常開支專案
分布式计算环境=分散式運算環境
高性能文件系统=高效能檔案系統
宏越土石方工程=巨集越土石方工程
吉雅丝和罗克珊=吉雅絲和洛葛仙妮
金斯敦血红蛋白=京斯敦血紅蛋白
局域网多播地址=局域網多播位址
逻辑数据独立性=邏輯資料獨立性
曼斯菲尔德公园=曼斯費爾德公園
数据电路透明性=資料電路透明性
随机数生成程序=亂數產生程式
物理数据独立性=物理資料獨立性
项目型组织架构=專案型組織架構
亚利安德罗罗西=亞里安德羅羅西
用户建筑群网络=使用者建築群網路
知君以此忘帝力=知君以此忘帝利
自有三农歌帝力=自有三農歌帝利
长宏废旧金属回收=長巨集廢舊金屬回收
磁盘碎片整理工具=磁片磁碟重組工具
福雷斯特氏棘花鮨=福里斯特氏棘花鮨
工业标准体系结构=工業標準架構
决策支持信息系统=決策支援資訊系統
圣多美和普林西比=聖多美及普林西比島
斯塔米尿道悬吊术=斯泰咪尿道懸吊術
通用消息事务协议=通用消息事務協定
项目的投资创汇率=專案的投資創匯率
智能场景识别功能=智慧場景識別功能
智能模拟支持系统=智慧類比支援系統
朱宏路朱宏立交北=朱巨集路朱巨集立交北
非远程存储器存取=非遠端存放器存取
简单网关监视协议=簡單閘道監視協定
卡斯特里费拉尼科=卡斯翠費拉尼科
曼斯菲尔德新西兰=曼斯費爾德紐西蘭
圣剑埃克斯卡里巴=聖劍埃克斯加里巴
数据数字音频磁带=資料數位音訊磁帶
投资项目排列顺序=投資專案排列順序
项目集管理办公室=專案集管理辦公室
智能场景识别模式=智慧場景識別模式
智能输入输出接口=智慧輸入輸出介面
朱宏路朱宏立交东=朱巨集路朱巨集立交東
达勒姆大教堂和城堡=特勒姆大教堂和城堡
不是真正的认识对象=不是真正的認識物件
达拉姆汉弗莱修正案=達拉姆韓弗理修正案
分布式系统对象模式=分散式系統物件模式
计算机支持协同工作=電腦支援協同工作
宽带综合业务数字网=寬頻整合型服務數位網路
申请后提交文件清单=申請後提交檔清單
因特网控制消息协议=網際網路控制消息協定
多媒体数据版本管理=多媒體資料版本管理
分组交换公用数据网=封包交換公用資料網
梅萨沃德印第安遗址=梅薩山沃德印第安遺址
项目的经济净现值率=專案的經濟淨現值率
朱迪思赫恩的孤独感=裘蒂絲赫恩的孤獨感
波斯尼亚和黑塞哥维那=波士尼亞赫塞哥維納
费里斯史密斯二氏手术=費理斯史密斯二氏手術
美国数字铁路图片公司=美國數位鐵路圖片公司
签过字的战地任务文件=簽過字的戰地任務檔
未签字的战地任务文件=未簽字的戰地任務檔
