埃达=艾達
埃拉=艾拉
埃玛=艾瑪
赡养=安養
拙著=拙著
葆拉=寶拉
刨么=刨么
备档=備檔
程序设计=程式設計
变档=變檔
飚车=飆車
目标=標的
补档=補檔
相信=採信
车档=車檔
磁盘=磁碟
存档=存檔
乘车=搭車
搭档=搭檔
呆账=呆帳
单元格=單格
档案=檔案
档次=檔次
档号=檔號
档级=檔級
档期=檔期
地道=道地
注销=登出
低档=低檔
调档=調檔
读档=讀檔
赌档=賭檔
断档=斷檔
贩卖=販售
肺结核=肺癆
高档=高檔
来年=隔年
公交车=公車
公元=西元
亮度=光度
归档=歸檔
京剧=國劇
小学=國小
海登=海頓
毫安=毫安培
横档=橫檔
后档=後檔
胡涂=糊塗
换档=換檔
几档=幾檔
借着=藉著
减档=減檔
快捷方式=捷徑
解碼=解碼
晋档=晉檔
警犭=警犬
巨商=鉅賈
巨著=巨著
开档=開檔
冤大头=凱子
康乾=康乾
考虑=考量
刻录=燒錄
空档=空檔
圭达=奎達
老么=老么
模拟=類比
理查德=理查
莉萨=麗莎
利瓦伊=李維
两档=兩檔
双方=兩造
榴莲=榴槤
鲁思=露絲
鲁索=盧梭
论著=論著
罗讷=羅納
逃跑=落跑
洛特-加龙省=洛特
马里=馬利
马莎=瑪莎
满档=滿檔
默林=梅林
名著=名著
内档=內檔
奥姆=歐姆
帕特=派特
干酪=起司
乾坤=乾坤
乾隆=乾隆
强档=強檔
琼森=強生
清菜=清萊
游资=熱錢
胶卷=軟片
软驱=軟盤機
塞纳-马恩省=塞納
杀档=殺檔
删档=刪檔
沉默=沈默
沉沉=沈沈
什么=什么
窗口=視窗
餐具=食具
减肥=瘦身
双档=雙檔
走纸=送紙
要求=訴求
随员=隨扈
所著=所著
战友=同袍
图档=圖檔
土著=土著
退档=退檔
脱档=脫檔
瓦讷=瓦納
维恩=威恩
显著=顯著
象话=像話
象样=像樣
小么=小么
新潟=新潟
悉尼=雪梨
沙伦=雪倫
阿皮亚=亞庇
埃布尔=亞伯
推迟=延緩
分析=研判
么爸=么爸
么爹=么爹
么儿=么兒
么姑=么姑
么鸡=么雞
么姐=么姐
么舅=么舅
么妈=么媽
么妹=么妹
么么=么麽
么娘=么娘
么女=么女
么婶=么嬸
么叔=么叔
么西=么西
么么=么么
么爷=么爺
么姨=么姨
复印件=影本
营账=營帳
原档=原檔
远程=遠端
组件=元件
原著=原著
乔纳=約拿
怎么=怎么
账单=帳單
昭著=昭著
这档=這檔
著名=著名
中档=中檔
著称=著稱
著录=著錄
著述=著述
著书=著書
帮助=助益
著者=著者
著作=著作
换乘=轉乘
转档=轉檔
专著=專著
卓著=卓著
间距=字幅
信息=資訊
摆档=擺檔
抵制=杯葛
实行=採行
词汇=辭彙
档块=檔塊
点档=點檔
顶档=頂檔
东盟=東協
断么=斷么
反复=反覆
地瓜=蕃薯
风档=風檔
挖掘机=怪手
借机=藉機
基思=基斯
禀复=稟覆
了然=瞭然
门档=門檔
盘档=盤檔
俏么=俏么
三档=三檔
顺档=順檔
摊档=攤檔
位=位元
批注=註解
埃德温=愛德溫
艾丽斯=愛麗絲
埃默森=愛默生
埃尔维斯=艾維斯
艾滋病=愛滋病
安杰拉=安琪拉
曝光度=曝光度
保鲜膜=保鮮紙
北安省=北安省
贝亚德=貝爾德
北九州=北九洲
比特率=位元速率
变量名=變數名
标题栏=標題列
冰淇淋=冰淇淋
伯利兹=貝里斯
木偶戏=布袋戲
残奥委会=殘奧會
超链接=超連結
樱桃=車厘子
复位位=重定位
复位向=重定向
触摸屏=觸控式螢幕
吃火锅=打邊爐
大女孩=大個女
单位元=單位元
电锅炉=電鍋爐
冬奥委会=冬奧會
卡片阅读机=讀卡機
多渠道=多管道
烤面包机=多士爐
方程式=方程式
箭头键=方向鍵
仿真器=模擬器
分节符=分節符號
凤梨酥=鳳梨酥
传感器=感應器
干著急=乾著急
高质量=高品質
歌德堡=哥德堡
公车站=公車站
菜单=功能表
佣人房=工人房
国庆节=國慶日
好不好=好唔好
贺岁档=賀歲檔
黄金档=黃金檔
机顶盒=機上盒
及网格线=及格線
计算器=計數機
基线=基準線
加载器=載入器
间隔年=間隔年
兼容性=相容性
适配卡=介面卡
译码器=解碼器
解释器=解譯器
金钥匙=金鑰匙
判定树=決策樹
客户端=用戶端
肯尼亚=肯亞
老糊涂=老糊塗
红包袋=利是封
链接库=程式庫
列表框=清單方塊
罗安达=魯安達
螺丝起子=螺絲批
马普托=馬布多
老太太=歐巴桑
老伯伯=歐吉桑
并行线=平行線
特立尼达=千里達
签名文件=簽名檔
保证书=切結書
青奥委会=青奧會
情侣档=情侶檔
热插入=熱插拔
三宝垄=三寶瓏
五花肉=三層肉
三河城=三河鎮
鲑鱼=三文魚
刹帝力=刹帝利
标识符=識別碼
视盘机=視訊光碟機
十三么=十三么
手动档=手動檔
数据集=資料集
数据流=資料流程
数量值=數量詞
四眼田鸡=四眼仔
苏里南=蘇利南
桌面计算机=桌上型電腦
谈论着=談論著
特奥委会=特奧會
提档线=提檔線
通讯簿=通訊錄
同构型=同質性
投档线=投檔線
透光度=透光度
透光性=透光性
微电脑=微電腦
弗吉尔=維吉爾
维罗纳=維羅納
不记得=唔記得
洗面奶=洗面乳
洗发精=洗頭水
夏洛特=夏洛特
限定符=限定詞
显示适配器=顯示卡
小秘方=小貼士
谢尔顿=謝爾敦
心痒痒=心思思
串行化=序列化
阿西娜=雅典娜
高压锅=壓力鍋
样式表单=樣式表
么蛾子=么蛾子
杰里迈亚=耶利米
伊夫林=伊芙琳
伊莱贾=以利亞
乔舒亚=約書亞
月台票=月臺票
战线上=戰線上
只股票=檔股票
指甲刀=指甲鉗
主文档=主文件
状态栏=狀態列
卓别麟=卓別林
子程序=副程式
域值=欄位值
组织结构=組織圖
优化=最佳化
八度么=八度么
瘸子=跛腳佬
橡皮擦=擦紙膠
剎帝力=剎帝利
早上=朝頭早
超微粒=超微粒
打呼=扯鼻鼾
演双簧=扯貓尾
语句=陳述式
附加电路板=承載板
浴室=沖涼房
内存板=記憶板
打赤膊=打赤肋
地下钱庄=大耳窿
大男孩=大個仔
大脖子=大頸泡
汽车大灯=大光燈
扒钱包=打荷包
敲竹杠=打腳骨
发抖=打冷震
乡巴佬=大鄉里
钉鞋钉=打鞋碼
打么台=打么台
档快门=檔快門
档梁子=檔樑子
耍嘴皮子=得把口
看医生=睇醫生
客饭=碟頭飯
打小报告=篤背脊
对不起=對唔住
多得很=多籮籮
纨裤子弟=二世祖
癫痫=發羊吊
理发师傅=飛髮佬
理发店=飛髮舖
风水先生=風水佬
傻乎乎=戇居居
胳肢窝=胳肋底
隔离线=隔離線
观测档=觀測檔
复写纸=過底紙
这样也行=咁都得
年轻人=後生仔
后脑杓=後尾枕
混么九=混么九
酒精灯=火水燈
鸡毛撢子=雞毛掃
减半档=減半檔
减一档=減一檔
科特斯=科迪斯
多嘴多舌=口多多
围兜=口水肩
扩展槽=擴充槽
小老婆=老婆仔
强制反馈=力回饋
粒粒么=粒粒么
端口=連接埠
父子俩=兩仔爺
六么令=六么令
卢尔德俊=盧德俊
卢尔德龙=盧德龍
双层床=碌架床
录象机=錄像機
次货=籮底橙
缺德鬼=麻甩佬
马约特岛=馬約特
没良心=冇本心
没心肝=冇心肝
没心情=冇心機
看不下去=冇眼睇
蒙在鼓里=懵閉閉
浑头浑脑=懵盛盛
密密麻麻=密質質
莫尔德=莫爾德
目标的=目標的
那里档=那裡檔
水泥匠=泥水佬
气冲冲=嬲爆爆
诺曼底=諾曼地
奥姆档=歐姆檔
苹果派=蘋果批
乒乓球=乒乓波
令人讨厌=乞人憎
清么九=清么九
萨瓦纳=薩凡納
生意人=生意佬
矢量积=向量積
小意思=濕濕碎
吃哑巴亏=食死貓
实力雄厚=手瓜硬
捡破烂=收買佬
大拇指=手指公
四川么=四川么
折伞=縮骨遮
体温计=探熱針
拍马屁=托大腳
太妃糖=拖肥糖
回形针=萬字夾
威尔马=威爾瑪
无档尊=無檔尊
小朋友=細佬哥
小女孩=細路女
小朋友=細蚊仔
是不是=係唔係
打包票=寫包單
老想着=心掛掛
机灵鬼=醒目仔
么九刻=么九刻
么九牌=么九牌
么铺镇=么鋪鎮
么滩镇=么灘鎮
么塘乡=么塘鄉
么站镇=么站鎮
伊莱沙=以利沙
一肚子气=一泡氣
冥纸=陰司紙
渝丰么=渝豐么
岳高头=岳高頭
约拿书=約拿書
复位时=重定時
缓存器=暫存器
脚本=指令碼
直线上=直線上
控制台=主控台
组档线=組檔線
阿德里安=阿德里安
阿基米得=阿基米德
巴基斯坦=巴基斯坦
保存檔=保存檔
保证质量=保證品質
比塞塔=比薩斜塔
图释=表情符號
伯恩斯坦=伯恩斯坦
部分数据=部分資料
查阅数据=查閱資料
产品质量=產品品質
传送档=傳送檔
存款帐户=存款帳戶
导出单位=匯出單位
道德质量=道德品質
电子卷标=電子標籤
电子货币包=電子錢包
电子商场=電子商城
电子文文件=電子文檔
电子帐户=電子帳戶
对比档=對比檔
弗罗伊德=佛洛依德
服务质量=服務品質
工程质量=工程品質
工程数据=工程資料
共享档=共用檔
工艺档=工藝檔
工作质量=工作品質
古德里安=古德里安
海得拉巴=海德拉巴
韩国小姐=韓國小姐
护理查房=護理查房
护理质量=護理品質
呼么喝六=呼么喝六
环境变量=環境變數
环境质量=環境品質
基本数据=基本資料
技术水准=技術水準
技术档=技術檔
技术质量=技術品質
家庭计算机=家用電腦
兼容模式=相容模式
教学质量=教學品質
事务历史记录=交易記錄
交易帐户=交易帳戶
教育质量=教育品質
接口技术=介面技術
接口设计=介面設計
解释变量=解釋變數
进行销售=進行銷售
经常帐户=經常帳戶
克赖斯勒=克萊斯勒
空气质量=空氣品質
控制变量=控制變數
计帐文件=會計檔案
满文老档=滿文老檔
蒙哥马利=蒙哥馬利
米尔沃基=密爾沃基
仿真城市=模擬城市
模板工程=範本工程
派克兰帝=派克蘭帝
质量管理=品質管理
质量生活=品質生活
质量优良=品質優良
其他数据=其他資料
请求支持=請求支援
全局变量=全域變數
人山人海=人頭湧湧
任务指针=任務指標
经常=三不五時
三国小镇=三國小鎮
商品质量=商品品質
设计时间=設計階段
设计档=設計檔
什么档=什麼檔
古里古怪=神神化化
生活质量=生活品質
誓不甘休=誓不甘休
许可证管理=授權管理
手提电脑=手提電腦
数据流程图=資料流程圖
记录入=資料錄入
所有数据=所有資料
天天线上=天天線上
重设大小=調整大小
听着名字=聽著名字
图形接口=圖形介面
万事达卡=萬事達卡
网路日志=網路日誌
网络等待时间=網路延遲
文件名=檔案名稱
无线上网=無線上網
系统注册表=系統登錄
相关档=相關檔
响应时间=回應時間
响应速度=回應速度
消费数据=消費資料
新华社区=新華社區
资讯工程=資訊工程
性能指针=性能指標
学习数据=學習資料
亚伯拉罕=亞伯拉罕
妖怪手表=妖怪手錶
一乾二净=一乾二淨
一个档=一個檔
医疗质量=醫療品質
一塌糊涂=一塌糊塗
一些数据=一些資料
一直在线=一直線上
应付帐款=應付帳款
映射档=映射檔
用户接口=使用者介面
用户帐户=用戶帳戶
预付帐款=預付帳款
战国小蛮=戰國小蠻
账号激活=帳號啟動
帐户号码=帳戶號碼
帐户密码=帳戶密碼
帐户资料=帳戶資料
质量安全=品質安全
质量保证=品質保證
质量标准=品質標準
质量等级=品質等級
质量非常=品質非常
质量分数=品質分數
质量分析=品質分析
质量合格=品質合格
质量计划=品質計畫
质量记录=品質記錄
质量监督=品質監督
质量检验=品質檢驗
质量控制=品質控制
质量目标=品質目標
质量事故=品質事故
质量体系=品質體系
质量要求=品質要求
质量意识=品質意識
质量指针=品質指標
基准控件目=主控項目
数据名称=資料名稱
利伯维尔场=自由市場
巴埃灯鳉=巴埃燈鱂
巴塞罗那=巴塞隆納
兆赫=百萬赫茲
比例尺规=比例尺規
变量范围=變數範圍
变量分析=變數分析
标记变量=標記變數
表面质量=表面品質
标准档=標準檔
布尔日都镇=布日都鎮
草稿质量=草稿品質
闹哄哄=嘈喧巴閉
场相关性=場依存性
超级拍档=超級拍檔
超强生命=超強生命
程序质量=程式品質
初启程式=初啟程式
串行电路=串聯電路
创作空间=創作空間
刺激变量=刺激變數
访问方法=存取方法
访问时间=存取時間
访问速度=存取速度
指桑骂槐=單單打打
打印质量=列印品質
档案档=檔案檔
导出分数=匯出分數
导出规则=匯出規則
地位质量=地位品質
地址映像=位址映射
电子质量=電子品質
顶尖拍档=頂尖拍檔
动态仿真=動態模擬
多维金档=多維金檔
恩塞纳达=恩塞納達
二进制元=二進位元
法国小镇=法國小鎮
反光性能=反光性能
反向信道=反向通道
仿真程序=模擬程式
仿真负载=模擬負載
仿真软件=模擬軟體
仿真算法=模擬演算法
仿真语言=模擬語言
仿真作业=模擬作業
菲尔莫尔=菲爾莫爾
分离信道=分離通道
凤巢七层=鳳巢七層
附件列表=附件清單
辅佐证据=輔佐證據
佮档佮计=佮檔佮計
归档档=歸檔檔
古古怪怪=鬼五馬六
扳着脸=黑口黑面
胡弗纳尔=胡韋納爾
华东木蓝=華東木藍
举一反三=話頭醒尾
坏死因数=壞死因數
蒙古大夫=黃綠醫生
混全带么=混全帶么
吉非贝齐=吉非貝琪
记录影像=記錄影像
技术数据=技術資料
姬野柳丁=姬野柳丁
基因数量=基因數量
基准检验=基準測試
价格数据=價格資料
家事=家頭細務
兼容字符=相容字元
建议档=建議檔
事务号码=交易號碼
交易列表=交易清單
接口测试=介面測試
接口速率=介面速率
杰拉尔德=吉羅德
经常帐目=經常帳目
经济变量=經濟變數
经济支持=經濟支援
距离线索=距離線索
考虑平衡=考慮平衡
克里斯廷=克莉絲汀
空降级段=空降階段
空位元素=空位元素
空中支持=空中支援
快速响应=快速回應
矿道地铁=礦道地鐵
事不关己=闊佬懶理
蓝带排档=藍帶排檔
老马失蹄=老貓燒鬚
激光唱机=雷射唱機
链接结构=連結結構
连续变量=連續變數
了如指掌=瞭如指掌
流通渠道=流通管道
录像质量=錄影品質
逻辑移位元=邏輯移位元
罗里罗唆=囉哩囉唆
罗里罗嗦=囉哩囉嗦
一去不回=冇尾飛鉈
美国小姐=美國小姐
美国小子=美國小子
民国小王=民國小王
命令接口=命令介面
目标语言=目的語言
木腐菌类=木腐菌類
面无表情=木口木面
内存储器=內記憶體
尼赫迈亚记=尼希米記
东奔西跑=頻頻撲撲
质量属性=品質屬性
平衡质量=平衡品質
亲家母=親家奶奶
光天化日=日光日白
柔软体操=柔軟體操
软件文文件=軟體文檔
软件质量=軟體品質
颜色管理=色彩管理
颜色深度=色彩深度
沙巴士拉=沙巴斯拉
傻里傻气=傻傻更更
摄影本身=攝影本身
摄影本体=攝影本體
摄影本质=攝影本質
深蓝的海=深藍的海
汗流浃背=身水身汗
圣洛伦索=聖洛倫索
草苺=士多啤梨
视觉图标=視覺圖示
收益质量=收益品質
数据环境=資料環境
数据驱动=資料驅動
数据信道=資料通道
数据总线=資料匯流排
数字技术=數位技術
数字影像=數位影像
水平档距=水準檔距
税收档=稅收檔
顺序变量=順序變數
提升质量=提升品質
挑么挑六=挑么挑六
信道接口=通道介面
信道容量=通道容量
同甘共苦=同撈同煲
通信接口=通信介面
图片质量=圖片品質
图标位置=圖示位置
图像文文件=圖像文檔
图像质量=圖像品質
网络接口=網路介面
未清帐款=未清帳款
文档编制=文檔編制
文文件等级=文檔等級
文档翻译=文檔翻譯
文档检索=文檔檢索
档传送=檔傳送
档定义=檔定義
档共享=檔共用
档规约=檔規約
档空间=檔空間
档条文=檔條文
档维护=檔維護
或多或少=唔多唔少
不清不楚=唔清唔楚
无么三紧=無么三緊
校正质量=校正品質
西麻布尔日=西麻布日
系统文文件=系統文檔
相关响应=相關回應
向下兼容=向下相容
协议条款=協定條款
协议协议=協定協議
协议映像=協議映射
三心二意=心大心細
进进出出=行出行入
刑档内幕=刑檔內幕
虚空间=虛擬空間
旋乾转坤=旋乾轉坤
学习智能=學習智慧
么么小丑=么麼小丑
么正算符=么正算符
移位元指令=移位元指令
硬盘接口=硬碟介面
映像程序=映射程式
映像地址=映射位址
映像方式=映射方式
映像函数=映射函數
图像文件案=影像檔案
影像质量=影像品質
用户日志=使用者日誌
用户文文件=用戶文檔
语法兼容=語法相容
预算帐户=預算帳戶
原始档=原始檔
杂项帐户=雜項帳戶
装疯卖傻=詐癲扮傻
假惺惺=詐詐諦諦
战友排档=戰友排檔
帐户编码=帳戶編碼
照片质量=照片品質
致病因数=致病因數
智能原理=智慧原理
直接映像=直接映射
质量不变=品質不變
质量成本=品質成本
质量工程=品質工程
质量规划=品質規劃
质量检查=品質檢查
质量一定=品質一定
质量因素=品質因素
质量作用=品質作用
治疗能力=治療能力
智能仪表=智慧型儀器表
精打细算=知慳識儉
直线信道=直線通道
制造帐户=製造帳戶
中介变量=仲介變數
中天线上=中天線上
重要质量=重要品質
主存储器=主記憶體
数据图片=資料圖片
数据影像=資料影像
组织接口=組織介面
作品质量=作品品質
艾伯塔奥尔=阿爾比奧爾
文件管理器=檔案管理員
工程量列表=工程量清單
规范性档=規範性檔
拉斯韦加斯=拉斯維加斯
雷克雅未克=雷克雅維克
毛里塔尼亚=茅利塔尼亞
沙特阿拉伯=沙烏地阿拉伯
档浏览器=檔流覽器
巴布林贝赫=巴布林貝赫
半线性映像=半線性映射
比勒弗尔德=比勒費爾德
标准化变量=標準化變數
布尔日都苏木=布日都蘇木
不兼容元素=不相容元素
尝记大排档=嘗記大排檔
潮记大排档=潮記大排檔
磁头加载区=磁頭載入區
单系统映像=單系統映射
档板式遮阳=檔板式遮陽
文件快门速度=檔快門速度
德国小情人=德國小情人
电子的质量=電子的品質
对象式方法=物件式方法
多媒体文件=多媒體檔
多模式接口=多模式介面
多用户仿真=多用戶模擬
仿真计算机=模擬電腦
仿真模型库=模擬模型庫
仿真知识库=模擬知識庫
非专利档=非專利檔
凤凰大排档=鳳凰大排檔
凤宁大排档=鳳寧大排檔
广东大排档=廣東大排檔
广味大排档=廣味大排檔
光学不变量=光學不變數
广州大排档=廣州大排檔
海鲜大排档=海鮮大排檔
合水夜鱼档=合水夜魚檔
合兴大排档=合興大排檔
横扫鱼蛋档=橫掃魚蛋檔
鸿福大排档=鴻福大排檔
红旗大排档=紅旗大排檔
缓冲存储器=緩衝記憶體
兼容计算机=相容電腦
镜子大排档=鏡子大排檔
康记大排档=康記大排檔
控制器接口=控制器介面
罗胖大排档=羅胖大排檔
罗索四须魮=羅梭四須魮
马里安波普=馬里安波普
马里安尼尼=馬里安尼尼
莫把么弦拨=莫把么弦撥
木屋沙丁鱼=木屋沙甸魚
拍档闯情关=拍檔闖情關
三棉大排档=三棉大排檔
闪光性暗点=閃光性暗點
盛达大排档=盛達大排檔
数字数据网=數位資料網
阵列处理机=陣列處理器
顺德鱼生档=順德魚生檔
顺德渔生档=順德漁生檔
素宝大排档=素寶大排檔
苏闽大排档=蘇閩大排檔
所有权档=所有權檔
添运大排档=添運大排檔
图片的质量=圖片的品質
旺阁大排档=旺閣大排檔
维京群岛=維爾京群島
文文件数据库=文檔資料庫
档状态表=檔狀態表
温馨大排档=溫馨大排檔
乌斯塔里兹=烏斯塔里茲
宪法性档=憲法性檔
鑫来顺排档=鑫來順排檔
走路不长眼睛=行路唔帶眼
雅马哈鱼档=雅馬哈魚檔
么虫何足道=么蟲何足道
伊利诺伊州=伊利諾州
音频数据库=音訊資料庫
邮递员=郵件管理員
云台底座=雲台連接座
照片的质量=照片的品質
只读存储器=唯讀記憶體
质量分别为=品質分別為
执行器接口=執行器介面
中国小麦学=中國小麥學
自动曝光档=自動曝光檔
自动送纸器=自動送紙器
自适应系统=自我調整系統
自组织映像=自組織映射
最大总质量=最大總品質
最佳贼拍档=最佳賊拍檔
作品的质量=作品的品質
管理信息系统=執行資訊系統
新喀里多尼亚=新赫里多尼亞
移动滑动光标=移動滑動游標
原子质量单位=原子品質單位
伴随线性映像=伴隨線性映射
报表生成程序=報告產生器
死循环频率响应=閉環頻率回應
变量的情况下=變數的情況下
变量聚类分析=變數聚類分析
变量筛选分析=變數篩選分析
变量函数符号=變數函數符號
标准输出档=標準輸出檔
标准输入档=標準輸入檔
伯恩斯裸胸鳝=伯恩斯裸胸鱔
布尔日嘎苏台乡=布日嘎蘇台鄉
财务支持协议=財務支援協定
层次串行键码=層次序列鍵碼
朝鲜停战协议=朝鮮停戰協定
车辆质量分级=車輛品質分級
成组传输速度=成組傳送速率
磁头加载机构=磁頭載入機構
篡改信道信息=篡改通道資訊
达达内尔海峡=達達尼爾海峽
大口福兔头档=大口福兔頭檔
带电粒子质量=帶電粒子品質
待续数据标记=待續資料標記
当前默认目录=當前預設目錄
电子函件地址=電子函件位址
动态地址转换=動態位址轉換
对象管理结构=物件管理結構
多变量控制器=多變數控制器
多地址计算机=多位址電腦
多频道地电仪=多頻道地電儀
俄克拉何马州=奧克拉荷馬州
访问控制列表=存取控制清單
仿真支持系统=模擬支援系統
浮标的重心点=浮標的重心點
服务数据单元=服務資料單元
关系数据理论=關係資料理論
合成数字音频=合成數位音訊
宏流水线算法=巨集流水線演算法
混洗交换网络=混洗切換式網路
活期存款账户=活期存款帳戶
活期帐户存款=活期帳戶存款
加强生命支持=加強生命支持
接口定义语言=介面定義語言
接口描述语言=介面描述語言
金城湛江鸡档=金城湛江雞檔
精细质量模式=精細品質模式
卡斯特里特斯=卡斯翠特斯
空间数据编码=空間資料編碼
空间数据引擎=空間資料引擎
扩充数据输出=擴充資料輸出
连接单元接口=連接單元介面
罗比埃利奥特=羅比伊里亞德
逻辑信令信道=邏輯信令通道
妈妈家大排档=媽媽家大排檔
媒体控制接口=媒體控制介面
媒体相关接口=媒體相關介面
面向连接协议=連線導向協議
频率响应函数=頻率回應函數
平价海鲜排档=平價海鮮排檔
圃香园大排档=圃香園大排檔
认知映像系统=認知映射系統
入侵检测系统=入侵偵測系統
森杰生态置业=森傑生態置業
山佬火锅排档=山佬火鍋排檔
实时数码数据=即時數碼資料
数据存取路径=資料存取路徑
数据的可靠性=資料的可靠性
数据分析系统=資料分析系統
数据加密标准=資料加密標準
数据控制语言=資料控制語言
数据描述语言=資料描述語言
输入输出接口=輸入輸出介面
数字仿形控制=數位仿形控制
数字高程模型=數位高程模型
数字制作技术=數位製作技術
随机数生成器=亂數產生器
同一水平线上=同一水平線上
通用接口总线=通用介面匯流排
投标的有效期=投標的有效期
投资项目风险=投資專案風險
图形用户界面=圖形化使用者介面
网络结点接口=網路結點介面
网络文件传送=網路檔傳送
伪造信道信息=偽造通道資訊
文件传送协议=檔傳送協議
文件检验程序=檔檢驗程式
系统管理文件=系統管理檔
项目采购管理=專案採購管理
项目范围管理=專案範圍管理
项目分解结构=專案分解結構
项目风险管理=專案風險管理
项目时间管理=專案時間管理
项目团队管理=專案團隊管理
项目团队组建=專案團隊組建
消息传递接口=消息傳遞介面
页面描述语言=分頁描述語言
一个重要变量=一個重要變數
应收票据帐户=應收票據帳戶
用户特许文件=用戶特許檔
用户文件目录=使用者檔目錄
远程过程调用=遠程程序呼叫
园缘缘海鲜档=園緣緣海鮮檔
粤港澳大排档=粵港澳大排檔
重复加载曲线=重複載入曲線
整车装备质量=整車裝備品質
质量功能部署=品質功能部署
智能控制系统=智慧控制系統
智能拍摄模式=智慧拍攝模式
智能外围接口=智慧週邊介面
重点财务数据=重點財務資料
中国小麦锈病=中國小麥銹病
中国小说精萃=中國小說精萃
中国小说精粹=中國小說精粹
中国小说史略=中國小說史略
主机传送文件=主機傳送檔
朱利叶斯霍吉=朱利斯霍吉
煮三江大排档=煮三江大排檔
资本组合数字=資本組合數位
最大轴载质量=最大軸載品質
最大装载质量=最大裝載品質
电压门控信道=電壓門控通道
定期存款账户=定期存款帳戶
多端口内存=多埠記憶體
高喷装置移位元=高噴裝置移位元
股价敏感数据=股價敏感資料
国际申请档=國際申請檔
国家秘密档=國家秘密檔
化学门控信道=化學門控通道
基金销售档=基金銷售檔
交叉连结档=交叉連結檔
科霍戈的黄金=科爾戈的黃金
科霍戈的钥匙=科爾戈的鑰匙
连线作业控制=連線作業控制
音乐器材数字接口=樂器數位介面
敏感组件接口=敏感元件介面
仿真训练器材=模擬訓練器材
软件仿真假饵=軟體模擬假餌
音频输入设备=聲音輸入裝置
数据高速信道=資料高速通道
信道调度程序=通道調度程式
通信使用分析=通信流量分析
投资组织者=投資組合管理
韦斯特维克德=韋斯特維爾德
档分配时间=檔分配時間
无所事事行开=行行企企行開
现金使用分析=現金流量分析
显示单色信道=顯示單色通道
显示复合信道=顯示複合通道
应用程序编程接口=應用程式介面
竖排文字工具=直排文字工具
字符串列位并行=字串列位元並行
字符串列位串行=字串列位元串列
资金使用分析=資金流量分析
数据立案归档=資料立案歸檔
最高像素指针=最高圖元指標
国际日期变更线=國際換日線
食品质量与安全=食品品質與安全
特殊案件项目组=特殊案件專案組
质量技术监督局=品質技術監督局
巴伦西亚帕梅萨=巴倫西亞帕梅薩山
死循环加载宏电极=閉環增益集電極
变量协变量矩阵=變數協變數矩陣
标准化正态变量=標準化正態變數
不兼容形式系统=不相容形式系統
超文本传输协议=超文字傳輸協定
单变量控制系统=單變數控制系統
单色显示适配器=單色顯示介面卡
党氏火锅大排档=黨氏火鍋大排檔
的音频记录模式=的音訊記錄模式
电路交换数据网=電路交換資料網
电子战支持设备=電子戰支援設備
对象链接与嵌入=物件連結與嵌入
对象式程序设计语言=物件式程式設計語言
多用户操作系统=多使用者作業系統
二进制对称信道=二進位對稱通道
法师文文件内存=法師文檔記憶體
非工程系统仿真=非工程系統模擬
非线性系统仿真=非線性系統模擬
分布式对象技术=分散式物件技術
分组交换数据网=封包交換數據網
浮标的自身语言=浮標的自身語言
复仇军数据单元=復仇軍資料單元
弗坦克德莫罗尼=弗坦克德莫洛尼
关税贸易总协议=關稅貿易總協定
广东人家大排档=廣東人家大排檔
过渡帐户票据交=過渡帳戶票據交
国际标准化组织=國際標準組織
化学家艾伯塔顿=化學家阿爾比頓
吉奥纳塔米高奇=吉奧納泰咪高奇
胶体和接口化学=膠體和介面化學
结构化编辑程序=結構編輯程式
晶体缺陷与接口=晶體缺陷與介面
精选交易商协议=精選交易商協定
卡桑德拉的炼狱=卡珊多拉的煉獄
可程序设计通信界面=可程式設計通信介面
科霍戈的藏宝图=科爾戈的藏寶圖
可扩展链接语言=可擴展連結語言
控制计算机接口=控制電腦介面
马尔维纳斯群岛=福克蘭群島
媒体接口连接器=媒體介面連接器
明日酒醒空想像=明日酒醒空想像
明珠海鲜加工档=明珠海鮮加工檔
模型参考自适应=模型參考自我調整
男人三十捣蛋=男人三十攪攪震
农家鱼头大排档=農家魚頭大排檔
质量进一步改善=品質進一步改善
桥东小区大排档=橋東社區大排檔
汝等岂知蒙帝力=汝等豈知蒙帝利
沙丁鱼杀人事件=沙甸魚殺人事件
世纪大道地铁站=世紀大道地鐵站
师生拍档追女仔=師生拍檔追女仔
数字视频特技机=數位視訊特技機
水平线上的阴谋=水平線上的陰謀
四季升级大排档=四季升級大排檔
他时干蛊声名着=他時幹蠱聲名著
瓦伦西亚帕梅萨=瓦倫西亞帕梅薩山
围村有嘢捣蛋=圍村有嘢攪攪震
惟惜平生旧着书=惟惜平生舊著書
调频管理=無線電頻率管理
系统性能监视器=系統效能監視器
夏洛特阿马利亚=夏洛特阿馬利亞
先锋军情报文档=先鋒軍情報文檔
晓航火锅大排档=曉航火鍋大排檔
心知帝力同天地=心知帝利同天地
英属维尔京群岛=英屬維京群島
应用服务提供商=應用服務提供者
悦肴清真大排档=悅肴清真大排檔
曾侍土阶知帝力=曾侍土階知帝利
泽布尔日多夫斯基=澤布日多夫斯基
直接内存访问=直接記憶體存取
质量和性能测试=品質和性能測試
制造自动化协议=製造自動化協定
自适应神经网络=自我調整神經網路
自适应用户接口=自我調整使用者介面
自适应预测编码=自我調整預測編碼
湖南卫视线上直播=湖南衛視線上直播
搜狗输入法智能版=搜狗輸入法智慧版
办理档副本请求=辦理檔副本請求
薄膜质量传递系数=薄膜品質傳遞係數
财务数据披露规则=財務資料披露規則
测试数据生成程序=測試資料生成程式
查询报失股票数据=查詢報失股票資料
程序设计支持环境=程式設計支援環境
串联质量光谱分析=串聯品質光譜分析
慈溪吉祥海鲜排档=慈溪吉祥海鮮排檔
内存数据寄存器=記憶體資料寄存器
单程式流多数据流=單程式流多資料流程
单位脉冲响应函数=單位脈衝回應函數
电报数据自动交换=電報資料自動交換
东南质量技术检测=東南品質技術檢測
多变量判别分析法=多變數判別分析法
费里斯史二氏手术=費理斯史二氏手術
分支机构往来帐户=分支機搆往來帳戶
风险投资公司档=風險投資公司檔
高级数据链路控制=高階資料連結控制
关税及贸易总协议=關稅及貿易總協定
关税与贸易总协议=關稅與貿易總協定
国强生态农业开发=國強生態農業開發
赫罗纳阿卡斯瓦伊=赫羅納阿卡斯瓦伊
后备数据复原软件=後備資料復原軟體
会计信息的质量特=會計資訊的品質特
绩溪宏源电力工程=績溪巨集源電力工程
科霍戈的秘密宝藏=科爾戈的秘密寶藏
可扩缩一致性接口=可擴縮一致性介面
空间时间聚集数据=空間時間聚集資料
快门响应极为迅速=快門回應極為迅速
亮子大排档五河县=亮子大排檔五河縣
逻辑链路控制协议=邏輯鏈路控制協定
摩尔质量排除极限=摩爾品質排除極限
南果专线南导出租=南果專線南匯出租
尼康映像仪器销售=尼康映射儀器銷售
世界百科名着总览=世界百科名著總覽
数据电路终接设备=資料電路終接設備
太阳神卡拉马利亚=太陽神卡拉馬利亞
腾腾香美食大排档=騰騰香美食大排檔
铁电非易失存储器=鐵電非動態記憶體
网络新闻传送协议=網路新聞傳送協定
为保证画面的质量=為保證畫面的品質
线性通信网路综合=線性通信網路綜合
项目人力资源管理=專案人力資源管理
小计算机系统接口=小電腦系統介面
虚拟控制程序接口=虛擬控制程式介面
虚拟设备驱动器=虛擬裝置驅動程式
瑶岭春汽锅大排档=瑤嶺春汽鍋大排檔
因特网服务提供商=網際網路服務提供者
因特网内容提供商=網際網路內容提供者
增强型小设备接口=增強型小設備介面
质量选择性检测器=品質選擇性檢測器
智能场景识别系统=智慧場景識別系統
智能家居布线系统=智慧家居佈線系統
中国大豆质量区划=中國大豆品質區劃
中央数字摄影频道=中央數位攝影頻道
自动摄影目标图像=自動攝影靶心圖表像
字节多路转换信道=位元組多路轉換通道
自卸汽车装载质量=自卸汽車裝載品質
最佳拍档大显神通=最佳拍檔大顯神通
巴里安廷斯基进行曲=巴里安廷斯基進行曲
超级视频图形适配器=超級視訊圖形介面卡
传声器声压频率响应=傳聲器聲壓頻率回應
存储模块驱动器接口=存儲模組驅動器介面
多点二进制文件传送=多點二進位檔案傳送
多媒体数据存储管理=多媒體資料存儲管理
国际申请的申请数据=國際申請的申請資料
基于知识的仿真系统=基於知識的模擬系統
加速度和质量的关系=加速度和品質的關係
加载和存储体系结构=載入和存儲體系結構
简便的目录访问协议=簡便的目錄訪問協定
健康疾病接口数据库=健康疾病介面資料庫
将通道作为选区加载=將通道作為選區載入
人的本质力量对象化=人的本質力量物件化
手续档审批通知书=手續檔審批通知書
项目的经济换汇成本=專案的經濟換匯成本
有虫子的科霍戈黄金=有蟲子的科爾戈黃金
指向性响应图案测量=指向性回應圖案測量
中国近代工业史数据=中國近代工業史資料
自动测试数据生成器=自動測試資料生成器
紫外线色素沉着作用=紫外線色素沉著作用
组织因子信道抑制剂=組織因數通道抑制劑
最佳拍档之大显神通=最佳拍檔之大顯神通
八仙饭店之人肉叉烧包=八仙飯店之人肉叉燒飽
蚌端口市地税局信息中心=蚌埠市地稅局資訊中心
大鸡唔食细米一鸡三吃=大雞唔食細米大雞三味
大西洋东南森林保护区=大西洋東南森林保護區
电子专利申请系统用户=電子專利申請系統使用者
福雷斯特帕克血红蛋白=福里斯特派克血紅蛋白
浮游生物浮标的灵敏度=浮游生物浮標的靈敏度
后期数字图像处理技术=後期數位影像處理技術
即夜传送报告数据服务=即夜傳送報告資料服務
将球停下等待队友支持=將球停下等待隊友支援
穆斯保尔效应数据索引=穆斯保爾效應資料索引
山水土木工程品质检测=山水土木工程品質檢測
圣文森特和格林纳丁斯=聖文森特和格林納丁斯群島
石油炼制技术资料手册=石油煉製技術資料手冊
牙齿及支持结构的疾患=牙齒及支援結構的疾患
质子加速器控制面板使用=質子加速器控制台使用
最佳拍档之兵马俑风云=最佳拍檔之兵馬俑風雲
