啊啊=﻿啊啊
阿斗=阿斗
哀吊=哀悼
挨冻=受凍
挨罚=受罰
挨骂=挨駡
安闲=安閒
笆斗=笆斗
巴里=巴里
霸占=霸佔
八只=八隻
摆布=擺佈
白发=白髮
白干=白乾
百里=百里
白面=白麵
拜寿=拜夀
拜托=拜託
板报=壁報
颁布=頒佈
班房=監獄
半只=半隻
帮闲=幫閒
帮凶=幫兇
报道=報導
报复=報復
包干=包乾
包伙=包伙
刨子=鉋子
北斗=北斗
卑污=卑污
背运=揹運
碑志=碑誌
备注=備註
笔杆=筆桿
比干=比干
笔画=筆劃
鼻梁=鼻樑
遍布=遍佈
编程=程式設計
遍历=遍歷
变量=變數
扁食=餛飩
表带=錶帶
表壳=錶殼
表链=錶鏈
表盘=錶盤
标签=標籤
表象=表像
表芯=錶芯
表针=錶針
表征=表徵
标志=標誌
标致=標緻
标准=標準
别扭=彆扭
鬓发=鬢髮
并案=併案
并发=併發
饼干=餅乾
冰棍=冰棒
病历=病歷
并拢=併攏
并入=併入
并吞=併吞
病愈=病癒
病征=病徵
波谷=波谷
卜庄=卜莊
卜卜=卜蔔
卜辞=卜辭
布道=佈道
布防=佈防
不复=不復
布告=佈告
卜卦=卜卦
布景=佈景
布局=佈局
卜居=卜居
卜课=卜課
布雷=佈雷
布满=佈滿
布设=佈設
布施=佈施
布线=佈線
布阵=佈陣
布置=佈置
擦干=擦乾
采办=採辦
采编=採編
裁并=裁併
采茶=採茶
采伐=採伐
采访=採訪
采购=採購
采光=採光
采花=採花
采集=採集
采金=採金
彩卷=彩捲
采掘=採掘
采矿=採礦
采莲=採蓮
采录=採錄
采买=採買
采煤=採煤
采纳=採納
采暖=採暖
采取=採取
采桑=採桑
采石=採石
采食=採食
采收=採收
采挖=採挖
采撷=採擷
采信=採信
采样=採樣
采用=採用
采油=採油
采择=採擇
采摘=採摘
采制=採制
采种=採種
惨象=慘像
茶几=茶几
茶碱=茶鹼
茶托=茶託
茶锈=茶銹
拆台=拆臺
铲除=剷除
单于=單于
长发=長髮
炒面=炒麵
撤消=撤銷
抻面=抻麵
秤杆=秤桿
蛏干=蟶乾
逞凶=逞兇
称赞=稱讚
叱骂=叱駡
斥骂=斥駡
冲程=衝程
冲冲=衝衝
冲床=衝床
冲刺=衝刺
冲动=衝動
冲锋=衝鋒
冲冠=衝冠
冲击=衝擊
冲激=衝激
冲劲=衝勁
冲开=衝開
冲口=衝口
冲垮=衝垮
冲浪=衝浪
冲力=衝力
冲量=衝量
冲破=衝破
冲杀=衝殺
冲突=衝突
宠幸=寵倖
冲压=衝壓
冲要=衝要
冲撞=衝撞
冲子=衝子
抽斗=抽斗
丑角=丑角
丑类=丑類
臭骂=臭駡
抽签=抽籤
丑时=丑時
抽闲=抽閒
出台=出臺
触须=觸鬚
传布=傳佈
船台=船臺
船只=船隻
窗棂=窗櫺
窗台=窗臺
纯碱=純鹼
春卷=春捲
词汇=詞彙
磁针=磁鍼
葱郁=蔥郁
存盘=存檔
存折=存摺
大梁=大樑
大曲=大麯
呆账=呆帳
胆碱=膽鹼
蛋卷=蛋捲
党国=党國
党江=党江
当啷=噹啷
导出=匯出
倒台=倒臺
德里=德里
得闲=得閒
登台=登臺
灯台=燈檯
等闲=等閒
嘀嗒=滴答
低谷=低谷
帝后=帝后
敌台=敵臺
电表=電錶
殿后=殿后
电台=電臺
玷污=玷污
吊祭=弔祭
吊丧=弔喪
吊孝=弔孝
吊唁=弔唁
叮当=叮噹
定准=定準
动荡=動盪
栋梁=棟樑
冬闲=冬閒
斗车=斗車
斗胆=斗膽
斗方=斗方
豆干=豆干
斗拱=斗拱
斗湖=斗湖
斗笠=斗笠
斗门=斗門
豆面=豆麵
斗篷=斗篷
斗渠=斗渠
斗室=斗室
斗子=斗子
独占=獨佔
短发=短髮
端口=埠
对准=對準
多只=多隻
恶心=噁心
二只=二隻
发辫=髮辮
发鬓=髮鬢
发布=發佈
发菜=髮菜
发粉=髮粉
发肤=髮膚
发髻=髮髻
发际=髮際
发夹=髮夾
发胶=髮膠
发卡=髮卡
发蜡=髮蠟
发廊=髮廊
珐琅=琺瑯
发露=髮露
发面=發麵
发妻=髮妻
发式=髮式
发丝=髮絲
发屋=髮屋
发泄=發洩
发型=髮型
发油=髮油
发指=髮指
翻斗=翻斗
范儿=范兒
范范=范範
反复=反復
范洪=范洪
范华=范華
范姐=范姐
反馈=回饋
泛滥=氾濫
范雷=范雷
范龙=范龍
范宁=范寧
范平=范平
范强=范強
范荣=范榮
范帅=范帥
范水=范水
范阳=范陽
范爷=范爺
范曾=范曾
范庄=范莊
放松=放鬆
防台=防颱
防锈=防銹
房檐=房檐
仿真=模擬
仿制=仿製
肺脏=肺臟
分布=分佈
丰采=丰采
风斗=風斗
风干=風乾
蜂后=蜂后
丰韵=丰韻
缝制=縫製
丰姿=丰姿
复辟=復辟
俯冲=俯衝
复仇=復仇
复旦=復旦
复发=復發
复工=復工
复古=復古
复函=復函
复会=復會
复婚=重婚
复活=復活
复旧=復舊
复刊=復刊
复苏=復蘇
付托=付託
复位=復位
复线=複綫
复信=覆信
复兴=復興
浮游=浮游
复原=復原
复员=復員
复制=複製
复种=復種
复壮=復壯
干碍=干礙
干爸=乾爸
干巴=乾巴
干杯=乾杯
干贝=干貝
干瘪=乾癟
干冰=乾冰
干菜=乾菜
干草=乾草
干柴=乾柴
杆秤=桿秤
干城=干城
干脆=乾脆
干等=乾等
干爹=乾爹
干饭=乾飯
干犯=干犯
干粉=乾粉
干戈=干戈
干果=乾果
干旱=乾旱
干号=乾號
干涸=乾涸
干货=乾貨
干姜=乾薑
干姐=乾姐
干净=乾淨
杆菌=桿菌
干咳=乾咳
干渴=乾渴
干枯=乾枯
干酪=乾酪
干冷=乾冷
干连=干連
干粮=乾糧
干裂=乾裂
干馏=乾餾
干路=乾路
干妈=乾媽
干妹=乾妹
干面=乾麵
干娘=乾娘
干亲=乾親
干求=干求
干扰=干擾
干涩=乾澀
干涉=干涉
干尸=乾屍
干瘦=乾瘦
干爽=乾爽
干松=乾鬆
干洗=乾洗
干系=干係
干笑=乾笑
干薪=乾薪
干休=干休
干谒=干謁
干预=干預
肝脏=肝臟
干燥=乾燥
干炸=乾炸
干政=干政
干支=干支
钢梁=鋼樑
港台=港臺
高寿=高夀
高台=高臺
割舍=割捨
公布=公佈
工场=工廠
公里=公里
公元=西元
攻占=攻佔
谷地=谷地
谷谷=谷穀
谷姐=谷姐
故里=故里
谷米=谷米
谷饶=谷饒
谷水=谷水
谷王=谷王
谷阳=谷陽
谷岳=谷嶽
挂斗=掛斗
刮风=颳風
挂面=掛麵
关系=關係
光标=游標
光复=光復
归并=歸併
硅谷=矽谷
龟鉴=高抬貴手
柜台=櫃檯
果干=果乾
锅台=鍋臺
过载=超載
海登=海頓
汗碱=汗鹼
毫安=毫安培
毫发=毫髮
毫厘=毫釐
合并=合併
何干=何干
河谷=河谷
和面=和麵
和弦=和絃
黑发=黑髮
恒产=恆產
横梁=橫樑
烘干=烘乾
红曲=紅麴
后梁=後樑
后台=後臺
胡蝶=蝴蝶
护发=護髮
胡须=鬍鬚
胡子=鬍子
划船=划船
华发=華髮
华里=華里
哗然=譁然
划算=划算
划艇=划艇
怀表=懷錶
缓冲=緩衝
缓征=緩徵
黄发=黃髮
皇后=皇后
毁谤=譭謗
汇报=彙報
汇编=彙編
回采=回採
汇丰=滙豐
回复=回復
恢复=恢復
汇集=彙集
汇聚=彙聚
回响=迴響
回旋=迴旋
洄游=洄游
回游=回游
汇整=彙整
绘制=繪製
伙房=伙房
伙夫=伙夫
伙食=伙食
箕斗=箕斗
激活=啟動
脊梁=脊樑
系绳=繫繩
寄托=寄託
挤占=擠佔
几只=幾隻
基准=基準
假发=假髮
家伙=傢伙
加里=加里
假托=假託
假象=假像
佳肴=佳餚
加载=載入
夹注=夾註
兼并=兼併
剪彩=剪綵
碱地=鹼地
碱度=鹼度
剪发=剪髮
奸夫=姦夫
碱化=鹼化
碱荒=鹼荒
简历=簡歷
奸情=姦情
兼容=相容
奸污=姦污
碱性=鹼性
奸淫=姦淫
监制=監製
舰只=艦隻
奖杯=獎盃
姜成=姜成
姜丰=姜豐
姜戈=姜戈
姜华=姜華
姜姜=姜薑
姜江=姜江
姜兰=姜蘭
姜黎=姜黎
姜林=姜林
姜龙=姜龍
姜楼=姜樓
姜梅=姜梅
姜南=姜南
姜宁=姜寧
姜平=姜平
姜强=姜強
姜尚=姜尚
姜舒=姜舒
姜帅=姜帥
姜水=姜水
姜苏=姜蘇
讲台=講臺
姜汤=姜湯
姜文=姜文
姜武=姜武
姜燕=姜燕
姜阳=姜陽
姜英=姜英
姜庄=姜莊
胶卷=膠捲
叫骂=叫駡
侥幸=僥倖
校准=校準
借端=藉端
结发=結髮
拮据=拮据
接口=介面
借以=藉以
筋斗=筋斗
斤斗=斤斗
金发=金髮
尽管=儘管
尽快=儘快
尽量=儘量
尽先=儘先
尽早=儘早
进占=進佔
尽自=儘自
经历=經歷
精辟=精闢
镜台=鏡臺
井台=井臺
精致=精緻
精制=精製
径自=逕自
酒曲=酒麴
酒坛=酒罈
巨商=鉅賈
卷标=標籤
卷发=卷髮
卷进=捲進
卷帘=捲簾
卷曲=捲曲
卷绕=捲繞
卷入=捲入
卷舌=捲舌
卷缩=捲縮
卷逃=捲逃
卷筒=捲筒
卷须=卷鬚
卷烟=捲煙
开采=開採
开辟=開闢
开涮=尋開心
开征=開徵
刊布=刊佈
看台=看臺
康复=康復
克复=克復
刻录=燒錄
克星=剋星
空闲=空閒
枯干=枯乾
垮台=垮臺
夸赞=誇讚
宽松=寬鬆
坤表=坤錶
拉面=拉麵
拉手=把手
蜡台=蠟臺
来历=來歷
老板=老闆
擂台=擂臺
棱台=棱臺
里昂=里昂
历朝=歷朝
历程=歷程
里程=里程
历次=歷次
历代=歷代
里尔=里爾
理发=理髮
立户=定居
里加=里加
里间=里間
漓江=灕江
历届=歷屆
历劫=歷劫
历尽=歷盡
历经=歷經
历久=歷久
里拉=里拉
历来=歷來
历历=歷歷
历练=歷練
里弄=里弄
厘米=釐米
历年=歷年
里诺=里諾
历任=歷任
历史=歷史
历时=歷時
历数=歷數
历险=歷險
链接=連結
联袂=連袂
联系=聯繫
炼制=煉製
晾干=晾乾
凉面=涼麵
两栖=兩栖
凉台=涼臺
晾台=晾臺
两只=兩隻
梁柱=樑柱
料斗=料斗
裂谷=裂谷
邻里=鄰里
榴莲=榴槤
六只=六隻
龙须=龍鬚
龙钟=龍鍾
漏斗=漏斗
楼台=樓臺
鸬鹚=鸕鷀
露台=露臺
炉台=爐臺
卤味=滷味
录制=錄製
乱发=亂髮
落发=落髮
履历=履歷
马表=馬錶
骂街=駡街
马里=馬里
骂名=駡名
脉冲=脈衝
曼谷=曼谷
漫卷=漫捲
谩骂=謾駡
漫骂=漫駡
曼延=蔓延
毛发=毛髮
茅台=茅臺
帽檐=帽檐
美发=美髮
每周=每週
猛冲=猛衝
蒙蒙=濛濛
蒙骗=矇騙
密布=密佈
米里=米里
米面=米麵
密致=密緻
面包=麵包
面茶=麵茶
面点=麵點
面肥=麵肥
面粉=麵粉
面馆=麵館
面糊=麵糊
面酱=麵醬
面筋=麵筋
面食=麵食
面市=上市
面汤=麵湯
面条=麵條
面团=麵團
面线=麵線
瞄准=瞄準
墨斗=墨斗
墨迹=墨蹟
莫里=莫里
模板=範本
母板=主機板
母后=母后
墓志=墓誌
耐碱=耐鹼
奶名=乳名
奶头=乳頭
南斗=南斗
内脏=內臟
啮合=嚙合
宁安=甯安
宁边=甯邊
宁成=甯成
宁达=甯達
宁儿=甯兒
宁丰=甯豐
拧干=擰乾
宁哥=甯哥
宁国=甯國
宁杭=甯杭
宁江=甯江
宁姐=甯姐
宁晋=甯晉
宁康=甯康
宁乐=甯樂
宁南=甯南
宁宁=甯寧
宁平=甯平
宁强=甯強
宁王=甯王
宁武=甯武
宁阳=甯陽
农闲=農閒
浓郁=濃郁
怒骂=怒駡
帕特=派特
盘石=磐石
跑表=跑錶
抛洒=抛灑
炮台=炮臺
炮制=炮製
佩里=佩里
配制=配製
蓬松=蓬鬆
烹制=烹製
披发=披髮
批复=批復
辟谣=闢謠
脾脏=脾臟
批注=批註
朴成=朴成
凭吊=憑弔
平复=平復
平谷=平谷
平台=平臺
朴朴=朴樸
凄楚=悽楚
凄怆=悽愴
七只=七隻
纤夫=縴夫
钱谷=錢谷
千里=千里
前台=前臺
签筒=籤筒
签子=籤子
枪杆=槍桿
强奸=強姦
强碱=強鹼
抢占=搶佔
强占=強佔
桥梁=橋樑
桥台=橋臺
亲历=親歷
侵占=侵佔
轻松=輕鬆
清闲=清閒
轻闲=輕閒
庆幸=慶倖
球果=毬果
求签=求籤
球台=球臺
渠道=管道
曲霉=麯黴
取舍=取捨
痊愈=痊癒
圈占=圈佔
染发=染髮
日干=日干
日志=日誌
肉干=肉乾
肉松=肉鬆
辱骂=辱駡
入托=入託
软驱=軟盤機
瑞签=瑞籤
若干=若干
弱碱=弱鹼
洒家=洒家
萨里=薩里
散布=散佈
三只=三隻
晒干=曬乾
晒台=曬臺
山谷=山谷
山后=山后
上梁=上樑
上台=上臺
上游=上游
伤愈=傷癒
烧碱=燒鹼
舍得=捨得
射干=射干
舍命=捨命
舍弃=捨棄
舍身=捨身
舍下=捨下
摄制=攝製
深谷=深谷
身历=身歷
肾脏=腎臟
生发=生髮
升华=昇華
生锈=生銹
盛赞=盛讚
适才=适才
事迹=事蹟
市里=市里
矢量=向量
石梁=石樑
施舍=施捨
石松=石鬆
试制=試製
十只=十隻
虱子=蝨子
手表=手錶
手电=手電筒
收复=收復
守恒=守恆
收获=收穫
寿面=壽麵
受托=受託
束发=束髮
疏松=疏鬆
水表=水錶
水碱=水鹼
水锈=水銹
水准=水準
四只=四隻
松绑=鬆綁
松弛=鬆弛
松脆=鬆脆
松动=鬆動
松紧=鬆緊
松劲=鬆勁
松开=鬆開
松口=鬆口
松快=鬆快
松软=鬆軟
松散=鬆散
松手=鬆手
松土=鬆土
松懈=鬆懈
酥松=酥鬆
算子=運算元
笋干=筍乾
孙宁=孫甯
孙岳=孫岳
塔里=塔里
塔台=塔臺
台胞=臺胞
台北=臺北
台本=臺本
台布=臺布
台步=臺步
台秤=臺秤
台词=臺詞
台灯=檯燈
台地=臺地
泰斗=泰斗
台端=臺端
胎发=胎髮
台风=颱風
太谷=太谷
太后=太后
台阶=臺階
台历=檯曆
台面=檯面
台钳=臺鉗
台球=檯球
台山=臺山
台上=臺上
台式=臺式
台湾=臺灣
台钟=臺鐘
台子=檯子
叹词=嘆詞
叹服=嘆服
叹号=嘆號
贪污=貪污
叹惜=嘆惜
叹羡=嘆羨
坛子=罎子
烫发=燙髮
汤面=湯麵
烫面=燙麵
汤团=湯糰
套式=模式
特征=特徵
特制=特製
藤椅=籐椅
剃发=剃髮
天干=天干
天后=天后
天台=天臺
跳梁=跳樑
跳台=跳臺
调制=調製
铁锈=鐵銹
停表=停錶
通奸=通姦
痛骂=痛駡
铜锈=銅銹
头发=頭髮
透辟=透闢
偷闲=偷閒
图标=圖示
土鳖=土鼈
图象=圖像
团粒=糰粒
推托=推託
吞并=吞併
托病=託病
托辞=託辭
拖斗=拖斗
脱发=脫髮
托福=託福
托付=託付
托管=託管
唾骂=唾駡
托名=託名
托偶=託偶
托盘=託盤
挽具=輓具
万里=萬里
万只=萬隻
往复=往復
王后=王后
维恩=威恩
喂饭=餵飯
喂料=餵料
喂奶=餵奶
喂食=餵食
委托=委託
伪托=偽託
维系=維繫
喂养=餵養
问卜=問卜
武丑=武丑
污点=污點
乌发=烏髮
无干=無干
污垢=污垢
污痕=污痕
武后=武后
污秽=污穢
污蔑=污蔑
诬蔑=誣衊
污泥=污泥
污染=污染
污辱=污辱
污水=污水
舞台=舞臺
五脏=五臟
五只=五隻
污浊=污濁
污渍=污漬
系词=係詞
洗发=洗髮
席卷=席捲
系念=繫念
系数=係數
稀松=稀鬆
戏台=戲臺
习用=慣用
细致=細緻
峡谷=峽谷
下梁=下樑
下面=下麵
下台=下臺
下咽=下嚥
下游=下游
咸安=咸安
闲扯=閒扯
闲愁=閒愁
闲荡=閒蕩
咸丰=咸豐
闲逛=閒逛
闲话=閒話
贤惠=賢慧
娴静=嫺靜
闲居=閒居
闲空=閒空
闲聊=閒聊
咸梅=咸梅
羡慕=羡慕
咸宁=咸寧
闲篇=閒篇
闲气=閒氣
闲钱=閒錢
闲情=閒情
闲人=閒人
闲散=閒散
闲事=閒事
闲时=閒時
闲适=閒適
娴熟=嫺熟
闲书=閒書
咸水=咸水
闲谈=閒談
闲庭=閒庭
闲暇=閒暇
闲心=閒心
闲雅=閒雅
咸阳=咸陽
闲逸=閒逸
闲游=閒遊
闲员=閒員
闲杂=閒雜
闲章=閒章
闲置=閒置
县志=縣誌
闲职=閒職
向导=嚮導
香干=香乾
相干=相干
乡里=鄉里
象是=像是
向往=嚮往
响应=回應
象征=象徵
小丑=小丑
笑骂=笑駡
削面=削麵
霄壤=天壤
消闲=消閒
消夜=宵夜
泄底=洩底
泄愤=洩憤
泄恨=洩恨
泄洪=洩洪
泄劲=洩勁
泄露=洩露
泄漏=洩漏
泄密=洩密
泄气=洩氣
信道=通道
信托=信託
欣羡=欣羡
心脏=心臟
幸存=倖存
星斗=星斗
幸免=倖免
邢台=邢臺
行凶=行兇
性征=性徵
凶暴=兇暴
凶残=兇殘
凶恶=兇惡
凶犯=兇犯
凶悍=兇悍
凶狠=兇狠
凶横=兇橫
凶狂=兇狂
凶猛=兇猛
凶器=兇器
凶气=兇氣
凶杀=兇殺
凶手=兇手
凶险=兇險
凶信=兇信
凶焰=兇焰
锈病=銹病
秀发=秀髮
修复=修復
锈蚀=銹蝕
休闲=休閒
须发=鬚髮
须根=鬚根
须眉=鬚眉
须生=鬚生
吁吁=吁吁
须子=鬚子
宣布=宣佈
悬梁=懸樑
宣泄=宣洩
旋子=鏇子
镟子=鏇子
削发=削髮
学历=學歷
血污=血污
巡回=巡迴
熏染=薰染
熏陶=薰陶
熏蒸=薰蒸
熏制=薰制
崖谷=崖谷
牙签=牙籤
烟斗=煙斗
檐沟=檐溝
盐碱=鹽鹼
烟碱=煙鹼
烟卷=煙捲
掩码=遮罩
烟台=煙臺
砚台=硯臺
研制=研製
阳台=陽臺
要冲=要衝
摇荡=搖盪
页岩=葉岩
仪表=儀錶
一并=一併
乙丑=乙丑
一干=一干
蚁后=蟻后
译码=解碼
依托=依託
胰脏=胰臟
一只=一隻
译制=譯製
一准=一準
银杯=銀盃
银发=銀髮
阴干=陰乾
音频=音訊
印台=印臺
印制=印製
音准=音準
影后=影后
英里=英里
荧幕=螢幕
映像=映射
应征=應徵
永恒=永恆
游白=游白
游标=游標
游车=游車
游程=游程
游方=游方
幽谷=幽谷
有恒=有恆
油迹=油蹟
诱奸=誘姦
游离=游離
游历=遊歷
游龙=游龍
游禽=游禽
游商=游商
游水=游水
油污=油污
悠闲=悠閒
幽闲=幽閒
游泳=游泳
游游=游遊
御笔=御筆
预卜=預卜
余成=余成
余盛=余盛
御赐=御賜
于达=于達
余单=余單
于儿=于兒
余丰=余豐
余高=余高
于哥=于哥
余割=余割
余杭=余杭
愈合=癒合
于洪=于洪
余洪=余洪
余华=余華
于华=于華
语汇=語彙
于吉=于吉
御驾=御駕
余江=余江
于江=于江
郁江=郁江
郁金=郁金
于康=于康
余柯=余柯
于兰=于蘭
余兰=余蘭
于蓝=于藍
余乐=余樂
于乐=于樂
于雷=于雷
余雷=余雷
于连=于連
余林=余林
于林=于林
郁林=郁林
于龙=于龍
余龙=余龍
于楼=于樓
于妈=于媽
于梅=于梅
余梅=余梅
余米=余米
郁南=郁南
于宁=于寧
余平=余平
于平=于平
御前=御前
余钱=余錢
于强=于強
余强=余強
余庆=余慶
御手=御手
于帅=于帥
于水=于水
鱼松=魚鬆
于田=于田
余万=余萬
余温=余溫
于文=于文
余文=余文
郁文=郁文
余弦=余弦
余项=余項
于燕=于燕
余姚=余姚
御医=御醫
余英=余英
于英=于英
御用=御用
御苑=御苑
预制=預製
于庄=于莊
于卓=于卓
御座=御座
圆台=圓臺
元凶=元兇
岳成=岳成
岳池=岳池
岳父=岳父
岳华=岳華
岳家=岳家
岳雷=岳雷
阅历=閱歷
岳林=岳林
岳龙=岳龍
岳母=岳母
岳宁=岳寧
岳强=岳強
月台=月臺
岳王=岳王
岳阳=岳陽
岳岳=岳嶽
岳丈=岳丈
岳庄=岳莊
熨斗=熨斗
云云=云云
杂志=雜誌
赞歌=讚歌
赞美=讚美
赞赏=讚賞
赞颂=讚頌
赞叹=讚歎
赞扬=讚揚
赞誉=讚譽
赞语=讚語
脏腑=臟腑
脏器=臟器
早泄=早洩
责骂=責駡
札幌=札幌
扎实=扎實
扎手=扎手
扎眼=扎眼
扎针=扎針
轧制=軋製
占卜=占卜
站点=網站
占据=佔據
战栗=戰慄
颤栗=顫慄
占领=佔領
毡帽=氊帽
展台=展臺
占先=佔先
占用=佔用
占有=佔有
毡子=氊子
账单=帳單
张皇=張惶
照准=照準
折冲=折衝
折伞=摺傘
折扇=摺扇
折子=摺子
震荡=震盪
振荡=振盪
征兵=徵兵
征调=徵調
征发=徵發
征稿=徵稿
征购=徵購
征候=徵候
征婚=徵婚
征集=徵集
症结=癥結
正梁=正樑
征募=徵募
征聘=徵聘
征求=徵求
征收=徵收
征税=徵稅
征文=徵文
征象=徵象
正凶=正兇
征询=徵詢
征引=徵引
征用=徵用
挣扎=掙扎
征兆=徵兆
征召=徵召
制版=製版
制备=製備
制表=製錶
制成=製成
制剂=製劑
制件=製件
制冷=製冷
质量=品質
致密=緻密
制片=製片
制品=製品
制钱=製錢
只身=隻身
制图=製圖
只眼=隻眼
制药=製藥
治愈=治癒
制造=製造
只字=隻字
制作=製作
钟爱=鍾愛
钟表=鐘錶
钟馗=鍾馗
钟情=鍾情
中游=中游
周报=週報
周二=週二
周刊=週刊
周六=週六
咒骂=咒駡
周末=週末
周期=週期
周三=週三
周四=週四
周五=週五
周薪=週薪
周一=週一
注册=註冊
注定=註定
主梁=主樑
烛台=燭臺
嘱托=囑託
注销=註銷
转台=轉檯
准备=準備
准儿=準兒
准将=準將
准谱=準譜
准确=準確
准绳=準繩
准时=準時
准头=準頭
准尉=準尉
准线=準線
准星=準星
准则=準則
捉奸=捉姦
字汇=字彙
资历=資歷
自制=自製
棕绷=棕綳
奏折=奏摺
钻台=鑽臺
芭芭=﻿芭芭
焙干=焙乾
并合=併合
卜陈=卜陳
卜儿=卜兒
卜强=卜強
卜英=卜英
党巴=党巴
党华=党華
党宁=党寧
党武=党武
跌交=跌跤
发绣=髮繡
范达=范達
范康=范康
范林=范林
范娄=范婁
范鲁=范魯
范马=范馬
范妹=范妹
范芮=范芮
范施=范施
范温=范溫
范禹=范禹
复盖=覆蓋
干禄=干祿
公厘=公釐
谷成=谷成
股分=股份
谷丰=谷豐
谷古=谷古
谷惠=谷惠
谷林=谷林
谷牛=谷牛
谷田=谷田
谷文=谷文
谷庄=谷莊
鹤发=鶴髮
记念=紀念
奸妇=姦婦
姜顾=姜顧
姜凌=姜淩
姜刘=姜劉
姜蒙=姜蒙
姜欧=姜歐
姜荣=姜榮
姜奕=姜奕
姜卓=姜卓
九只=九隻
卷动=捲動
镢头=鐝頭
炕几=炕几
夸脱=夸脫
了望=瞭望
宁梅=甯梅
宁盛=甯盛
宁师=甯師
宁田=甯田
宁岳=甯嶽
朴哥=朴哥
朴姐=朴姐
朴南=朴南
凄惶=悽惶
牵系=牽繫
清彻=清澈
倾复=傾覆
数只=數隻
松气=鬆氣
台盟=臺盟
台属=臺屬
条几=條几
头虱=頭蝨
秃发=禿髮
托派=託派
屋梁=屋樑
系辞=繫辭
闲笔=閒筆
闲步=閒步
咸池=咸池
闲房=閒房
闲季=閒季
闲静=閒靜
羡叹=羨嘆
闲田=閒田
须疮=鬚瘡
蓄发=蓄髮
游李=游李
游燕=游燕
于程=于程
余程=余程
余解=余解
于金=于金
御览=御覽
郁李=郁李
于梁=于梁
御批=御批
于庆=于慶
于嫂=于嫂
于师=于師
余水=余水
于武=于武
余闲=餘閒
于杨=于楊
于于=于於
余庄=余莊
岳胡=岳胡
岳南=岳南
岳师=岳師
岳夏=岳夏
岳燕=岳燕
宰制=宰製
阿卜杜=阿卜杜
阿里山=阿里山
艾奥瓦=愛荷華
埃德温=愛德溫
艾滋病=愛滋病
按计划=按計劃
安全局=安全局
拗口令=繞口令
奥马尔=奧馬爾
芭芭拉=芭芭拉
八字胡=八字鬍
白面儿=白面兒
白头发=白頭發
板擦儿=板擦
棒子面=棒子麵
爆发式=爆發式
爆发型=爆發型
北九州=北九洲
比特率=位元速率
表蒙子=錶蒙子
标题栏=標題列
标志位=標誌位元
冰棍儿=冰棍兒
冰激凌=冰淇淋
伯利兹=貝里斯
菠萝蜜=菠蘿蜜
布尔诺=布爾諾
不复习=不複習
不干胶=不乾膠
布吉岛=普吉島
不尽然=不儘然
不罗嗦=不囉嗦
不锈钢=不銹鋼
采空区=採空區
操纵台=操縱臺
操作台=操作臺
查号台=查號臺
常宁宫=常甯宮
城市里=城市裡
吃闲饭=吃閒飯
冲冲冲=衝衝沖
触摸屏=觸控式螢幕
慈宁宫=慈甯宮
催干剂=催乾劑
存储器=記憶體
打边鼓=敲邊鼓
打卤面=打鹵麵
大循环=大循環
打印台=列印台
打印头=打印頭
打印纸=打印紙
岱岳区=岱岳區
担担面=擔擔麵
党家庄=党家莊
党领导=党領導
党卫军=党衛軍
党支书=党支書
稻飞虱=稻飛蝨
邓朴方=鄧朴方
地卜师=地卜師
地方志=地方誌
第三只=第三只
敌占区=敵佔區
电度表=電度錶
电流表=電流錶
电视台=電視臺
电子表=電子錶
掉头发=掉頭發
钓鱼台=釣魚臺
豆腐干=豆腐乾
斗烟丝=斗煙絲
断头台=斷頭臺
对台戏=對臺戲
恶人谷=惡人谷
嗯啊啊=嗯啊啊
二人台=二人臺
发明了=發明了
范长江=范長江
范长龙=范長龍
范成大=范成大
范甘迪=范甘迪
范各庄=范各莊
范海辛=范海辛
范海燕=范海燕
范建华=范建華
范经理=范經理
范俊杰=范俊傑
范老师=范老師
范师傅=范師傅
范婷婷=范婷婷
范西路=范西路
范先生=范先生
范小姐=范小姐
范晓燕=范曉燕
范小雨=范小雨
范元成=范元成
范志强=范志強
范仲淹=范仲淹
范主任=范主任
方括号=方括號
肺循环=肺循環
分节符=分節符號
分厘卡=分釐卡
烽火台=烽火臺
负反馈=負反饋
氟塑料=氟塑料
复印件=影本
干打雷=乾打雷
干打垒=乾打壘
干瞪眼=乾瞪眼
干电池=乾電池
干儿子=乾兒子
干酵母=乾酵母
干姐姐=幹姐姐
干妹妹=幹妹妹
擀面杖=擀麵杖
干奶奶=乾奶奶
干女儿=乾女兒
感叹词=感歎詞
干洗剂=幹洗劑
干休所=幹休所
干眼症=乾眼症
干衣机=乾衣機
干着急=乾著急
港澳台=港澳臺
钢笔画=鋼筆畫
公交车=公車
工作台=工作臺
谷阿莫=谷阿莫
谷氨酸=谷氨酸
谷景生=谷景生
古柯碱=古柯鹼
谷梁传=谷梁傳
谷智鑫=谷智鑫
观象台=觀象臺
光华里=光華裡
国庆节=國慶日
哈里森=哈里森
海宁路=海甯路
函谷关=函谷關
航天部=航天部
航天局=航天局
航天器=航天器
号志灯=號誌燈
和平里=和平里
黑板报=黑板報
黑头发=黑頭發
很罗嗦=很囉嗦
横坐标=橫坐標
红薯干=紅薯乾
胡椒面=胡椒麵
划不来=划不來
华宁路=華甯路
化妆室=化粧室
怀宁路=懷甯路
黄曲霉=黃麴黴
挥发油=揮發油
回旋梯=回旋梯
机顶盒=機上盒
计划性=計劃性
集宁区=集甯區
计算法=計算法
鸡汤面=雞湯面
几天后=幾天後
加工场=加工場
假象牙=假象牙
碱金属=鹼金屬
建宁路=建甯路
兼容机=兼容機
姜半夏=姜半夏
姜博文=姜博文
姜大卫=姜大衛
姜国强=姜國強
姜海波=姜海波
姜海燕=姜海燕
姜海洋=姜海洋
江宁路=江甯路
江宁区=江甯區
姜太公=姜太公
姜婷婷=姜婷婷
姜卫东=姜衛東
姜先生=姜先生
姜秀华=姜秀華
姜堰区=姜堰區
姜异康=姜異康
姜宇航=姜宇航
姜玉阳=姜玉陽
交界面=交界面
解释器=解譯器
接头发=接頭發
警察局=警察局
晶粒度=晶粒度
静宁路=靜甯路
酒坛子=酒罈子
卷发器=捲髮器
卷铺盖=捲舖蓋
卷心菜=捲心菜
卷扬机=捲揚機
喀布尔=喀布爾
咖啡碱=咖啡鹼
卡莱尔=卡萊爾
卡路里=卡路里
卡西欧=卡西歐
客户端=用戶端
可可怜=可可憐
颗粒度=顆粒度
肯尼亚=肯亞
控制表=控制表
控制图=控制圖
快餐车=快餐車
快餐厅=快餐廳
坤宁宫=坤甯宮
蜡笔画=蠟筆畫
拉里萨=拉里薩
兰德里=蘭德裡
郎咸平=郎咸平
老姜王=老姜王
乐游原=樂游原
理查德=理查
里士满=里士滿
里斯本=里斯本
链接库=程式庫
列表框=清單方塊
领奖台=領獎臺
龙卷风=龍捲風
龙须面=龍鬚麵
龙眼干=龍眼乾
龙游路=龍游路
鲁谷路=魯谷路
罗安达=魯安達
萝卜干=蘿蔔乾
捋虎须=捋虎鬚
旅游车=旅遊車
马普托=馬布多
马莎莎=瑪莎莎
马蹄表=馬蹄錶
妈仔谷=媽仔谷
满洲里=滿洲里
芒果干=芒果幹
美人谷=美人谷
梦游计=夢游計
面包干=麵包幹
明星范=明星范
莫干山=莫干山
目标位=目標位元
木菠萝=木菠蘿
拿波里=拿波里
拿破仑=拿破崙
奶奶头=奶奶頭
奶制品=乳製品
尼罗河=尼羅河
尿毒症=尿毒癥
宁财神=甯財神
宁穿路=甯穿路
宁古塔=甯古塔
宁馨儿=甯馨兒
牛肉干=牛肉幹
牛肉面=牛肉麵
农历年=農曆年
帕里斯=帕里斯
排污口=排污口
抛物面=抛物面
抛物线=抛物線
彭于晏=彭于晏
皮肤干=皮膚乾
披肩发=披肩髮
朴宝英=朴寶英
朴恩惠=朴恩惠
朴槿惠=朴槿惠
朴敏英=朴敏英
朴施厚=朴施厚
朴信惠=朴信惠
朴修夏=朴修夏
朴宰范=朴宰範
朴振英=朴振英
朴智敏=朴智敏
朴智星=朴智星
朴智妍=朴智妍
苹果干=蘋果幹
破读字=破音字
朴初珑=朴初瓏
葡萄干=葡萄乾
启发式=啟發式
气象台=氣象臺
气压表=氣壓錶
铅笔画=鉛筆畫
千分表=千分錶
千万里=千萬裡
敲竹杠=敲竹槓
情人谷=情人谷
晴雨表=晴雨錶
去污粉=去污粉
去污剂=去污劑
肉丝面=肉絲麵
软磁盘=軟碟
润发乳=潤髮乳
撒啊啊=撒啊啊
塞卜哈=塞卜哈
三宝垄=三寶瓏
三元里=三元里
桑干河=桑乾河
沙发布=沙發布
上梁山=上梁山
上游街=上遊街
少罗嗦=少囉嗦
少年游=少年游
舍不得=捨不得
神谷姬=神谷姬
神算子=神算子
升降台=升降臺
生物碱=生物鹼
世界杯=世界盃
收藏夹=我的最愛
手持式=掌上型
手电筒=手電筒
手电钻=手電鑽
收款台=銷售點
寿宁路=壽甯路
手术台=手術臺
鼠标器=滑鼠
数据集=資料集
数据流=資料流程
数据位=數據位元
梳头发=梳頭發
梳妆台=梳粧檯
水平方=水平方
水平衡=水平衡
水平角=水平角
水平面=水平面
水平线=水平線
水平仪=水平儀
说不准=說不準
苏里南=蘇利南
酸奶粉=酸奶粉
孙佳宁=孫佳甯
塔什干=塔什干
太罗嗦=太囉嗦
台式机=桌上型電腦
台柱子=臺柱子
太子党=太子党
剃须刀=剃鬚刀
体循环=體循環
田范江=田范江
天宁区=天甯區
天文台=天文臺
通讯簿=通訊錄
吐谷浑=吐谷渾
托人情=託人情
王子宁=王子甯
维埃拉=維艾拉
威宁路=威甯路
威宁谢=威甯謝
位数字=位元數字
微循环=微循環
温度表=溫度錶
文汇报=文匯報
沃尔沃=富豪
五斗橱=五斗櫥
五斗柜=五斗櫃
五斗米=五斗米
乌干达=烏干達
五里雾=五里霧
武宁路=武甯路
洗面奶=洗面乳
西西里=西西里
下划线=底線
下拉框=下拉清單
夏于乔=夏于喬
闲不住=閒不住
闲工夫=閒工夫
仙后座=仙后座
闲磕牙=閒磕牙
咸宁路=咸甯路
咸水湖=鹹水湖
仙台山=仙台山
仙岳路=仙岳路
弦乐器=絃樂器
响当当=響噹噹
小可可=小可可
谢尔顿=謝爾敦
写字台=寫字臺
辛迪加=辛迪加
新山村=新山村
新台币=新臺幣
信息网=資訊網
兴冲冲=興沖沖
兴宁路=興甯路
兴宁区=興甯區
序列号=序號
虚飘飘=虛飃飃
学生党=學生党
穴位图=穴位圖
血循环=血循環
循环论=循環論
循环赛=循環賽
循环体=循環體
压力表=壓力錶
演讲台=演講台
阳春面=陽春麵
阳历年=陽曆年
扬子鳄=揚子鰐
夜光表=夜光錶
一出戏=一齣戲
抑制剂=抑制劑
邕宁区=邕甯區
游啊游=游啊遊
游巴蜀=游巴蜀
游不游=游不遊
油茶面=油茶麵
游惠宝=游惠寶
尤里卡=尤里卡
游戏迷=游戲迷
游侠客=游俠客
游仙区=游仙區
游呀游=游呀遊
游一游=游一遊
幽幽谷=幽幽穀
游走于=游走於
余安安=余安安
于长江=于長江
于成龙=于成龍
余楚媛=余楚媛
于春梅=于春梅
于春燕=于春燕
郁达夫=郁達夫
于大海=于大海
于得水=于得水
于广州=于廣州
于国华=于國華
于海滨=于海濱
于海波=于海波
余海波=余海波
于海军=于海軍
于海燕=于海燕
余海燕=余海燕
于海洋=于海洋
于海英=于海英
于红梅=于紅梅
于宏伟=于宏偉
雨花台=雨花臺
御花园=御花園
于佳平=于佳平
余佳文=余佳文
于建国=于建國
于建华=于建華
余建华=余建華
郁金香=鬱金香
余俊杰=余俊傑
于魁智=于魁智
于老师=于老師
于丽华=于麗華
于立新=于立新
御林军=御林軍
于荣光=于榮光
余莎米=余莎米
预算法=預算法
余天成=余天成
余婷婷=余婷婷
于先生=于先生
余先生=余先生
于小雪=于小雪
于晓燕=于曉燕
余小燕=余小燕
余秀华=余秀華
于雪梅=于雪梅
于艳丽=于豔麗
于洋洋=于洋洋
于右任=于右任
余则成=余則成
于志强=于志強
原计划=原計劃
岳夫人=岳夫人
岳各庄=岳各莊
岳国峰=岳國峰
岳麓区=岳麓區
岳塘区=岳塘區
岳西路=岳西路
炸酱面=炸醬麵
扎猛子=扎猛子
站柜台=站櫃臺
占便宜=佔便宜
站台票=站臺票
站台上=月臺上
占用费=占用費
占优势=佔優勢
掌子面=掌子麵
赵朴初=趙朴初
折子戏=折子戲
振动台=振動臺
镇宁路=鎮甯路
正宁路=正甯路
征文稿=征文稿
值班房=值班房
只股票=檔股票
质量数=質量數
指明了=指明了
只眼睛=只眼睛
周报表=周報表
主程序=主程序
主干路=主幹路
主干网=骨幹
主干线=骨幹
猪肉干=豬肉幹
主席台=主席臺
状态栏=狀態列
准噶尔=準噶爾
子程序=副程式
自适应=自我調整
纵坐标=縱坐標
嘴巴里=嘴巴裡
坐标系=坐標系
坐标轴=坐標軸
芭芭露=芭芭露
芭芭亚=芭芭亞
巴鲁索=巴盧梭
百只夠=百隻夠
百只可=百隻可
保儿宁=保兒甯
保宁路=保甯路
贝儿宁=貝兒甯
倍宁路=倍甯路
比埃拉=比艾拉
比萨里=比薩裡
笔算法=筆算法
扁豆面=扁豆面
编制表=編制表
卜冰武=卜冰武
卜道林=卜道林
卜凡宁=卜凡寧
卜范庆=卜范慶
卜桂英=卜桂英
卜国成=卜國成
卜惠洁=卜惠潔
波里蒂=波里蒂
波里斯=波里斯
卜林娟=卜林娟
卜令龙=卜令龍
卜庆国=卜慶國
卜石林=卜石林
卜万苍=卜萬蒼
卜营村=卜營村
卜永权=卜永權
卜张峰=卜張峰
卜章绍=卜章紹
卜祖成=卜祖成
布尔萨=布爾薩
布雷达=布雷達
布料器=佈料器
岑卜路=岑卜路
查准率=查準率
长干曲=長干曲
长谷路=長谷路
长须鲸=長鬚鯨
陈朴容=陳朴容
程序块=區塊
川谷楼=川谷樓
川岳楼=川岳樓
存储板=記憶板
大侠谷=大俠谷
党安芳=党安芳
党波涛=党波濤
党崇江=党崇江
党甘亭=党甘亭
党高军=党高軍
党红星=党紅星
党怀英=党懷英
党金江=党金江
党金良=党金良
党丽英=党麗英
党林山=党林山
党马乡=党馬鄉
党平业=党平業
党团员=党團員
党文奎=党文奎
党文学=党文學
党向军=党向軍
党向阳=党向陽
党兴强=党興強
党秀英=党秀英
党益龙=党益龍
党英海=党英海
党永华=党永華
党原乡=党原鄉
党智华=党智華
党宗彦=党宗彥
登科里=登科裡
洞宁路=洞甯路
董岳高=董岳高
渡船台=渡船台
队列表=隊列表
多拉多=多拉多
恩德里=恩德裡
二只得=二只得
范爱农=范愛農
范安华=范安華
范柏群=范柏群
范拜滕=范拜滕
范宝强=范寶強
范贝莱=范貝萊
范比滕=范比滕
范丙全=范丙全
范伯伦=范伯倫
范博梅=范博梅
范长寿=范長壽
范晨曦=范晨曦
范晨燕=范晨燕
范成龙=范成龍
范楚卿=范楚卿
范传达=范傳達
范丛丛=范叢叢
范德安=范德安
范德兰=范德蘭
范德全=范德全
范地国=范地國
范电华=范電華
范杜因=范杜因
范高彬=范高彬
范高儒=范高儒
范广成=范廣成
范广景=范廣景
范桂华=范桂華
范桂菊=范桂菊
范桂铭=范桂銘
范桂艳=范桂豔
范国华=范國華
范国焕=范國煥
范国琼=范國瓊
范国英=范國英
范哈伦=范哈倫
范海宁=范海寧
范海荣=范海榮
范和平=范和平
范鸿达=范鴻達
范红梅=范紅梅
范红燕=范紅燕
范胡青=范胡青
范胡特=范胡特
范霍恩=范霍恩
范霍特=范霍特
范记金=范記金
范吉明=范吉明
范家林=范家林
范家路=范家路
范健康=范健康
范将军=范將軍
范江鹏=范江鵬
范金宁=范金寧
范金泉=范金泉
范景峰=范景峰
范景华=范景華
范景琪=范景琪
范景涛=范景濤
范俊华=范俊華
范凯龙=范凱龍
范克龙=范克龍
范柯琴=范柯琴
范科文=范科文
范老大=范老大
范丽平=范麗平
范立新=范立新
范刘村=范劉村
范柳芳=范柳芳
范楼镇=范樓鎮
范路军=范路軍
范罗山=范羅山
范美玉=范美玉
范莫尔=范莫爾
番木鳖=番木鼈
范南村=范南村
范能全=范能全
范宁宁=范甯寧
范培林=范培林
范乔尼=范喬尼
范庆波=范慶波
范秋连=范秋連
范全军=范全軍
范群平=范群平
范仁龙=范仁龍
范仁全=范仁全
范瑞华=范瑞華
范润华=范潤華
范圣明=范聖明
范石泉=范石泉
范寿铭=范壽銘
范苏鲁=范蘇魯
范泰山=范泰山
范泰申=范泰申
范庭兰=范庭蘭
范同梅=范同梅
范万武=范萬武
范卫东=范衛東
范卫华=范衛華
范维蒙=范維蒙
范蔚宗=范蔚宗
范希华=范希華
范晞文=范晞文
范贤淑=范賢淑
范向前=范向前
范小龙=范小龍
范晓平=范曉平
范晓强=范曉強
范馨宁=范馨寧
范新强=范新強
范兴平=范興平
范秀华=范秀華
范秀平=范秀平
范修文=范修文
范秀英=范秀英
范绪成=范緒成
范雪华=范雪華
范雪梅=范雪梅
范学智=范學智
范亚南=范亞南
范艳兰=范豔蘭
范燕妮=范燕妮
范燕婷=范燕婷
范燕燕=范燕燕
范阳春=範陽春
范怡文=范怡文
范迎春=范迎春
范英明=范英明
范营乡=范營鄉
范永梅=范永梅
范友利=范友利
范玉强=范玉強
范余儒=范餘儒
范玉申=范玉申
范远荣=范遠榮
范云龙=范雲龍
范云妹=范雲妹
范展弘=范展弘
范章华=范章華
范张强=范張強
范正平=范正平
范正章=范正章
范志华=范志華
范智娇=范智嬌
范志梅=范志梅
范治平=范治平
范智睿=范智睿
范志申=范志申
范志颜=范志顏
范志英=范志英
范智勇=范智勇
范中华=范中華
范忠强=范忠強
范仲卿=范仲卿
范忠文=范忠文
范周琳=范周琳
范卓文=范卓文
范紫薇=范紫薇
范宗沛=范宗沛
方于鲁=方于魯
方岳路=方岳路
非独占=非獨占
丰谷路=豐谷路
丰宁路=豐甯路
奉宁路=奉甯路
丰宁原=豐甯原
复巢蜂=覆巢蜂
府谷路=府谷路
富宁路=富甯路
福宁路=福甯路
复盆子=覆盆子
干草原=幹草原
干城乡=幹城鄉
干果脯=幹果脯
干湿表=乾濕表
干性油=乾性油
干血浆=乾血漿
干眼病=乾眼病
港宁路=港甯路
高宁路=高甯路
高宁燕=高甯燕
阁游路=閣游路
工人党=工人党
古埃拉=古艾拉
谷博士=谷博士
谷德盛=谷德盛
谷海燕=谷海燕
谷红梅=谷紅梅
谷红星=谷紅星
谷建封=谷建封
谷锦华=谷錦華
谷金印=谷金印
谷静文=谷靜文
谷理沙=谷理沙
谷龙乡=谷龍鄉
谷明英=谷明英
谷青成=谷青成
谷曲乡=谷曲鄉
谷尚勇=谷尚勇
谷世孟=谷世孟
谷苏生=谷蘇生
谷汪乡=谷汪鄉
谷伟阳=谷偉陽
谷武阳=谷武陽
谷鲜楼=谷鮮樓
谷香居=谷香居
故乡里=故鄉裡
谷叶芳=谷葉芳
谷应泰=谷應泰
谷营乡=谷營鄉
谷玉龙=谷玉龍
谷元平=谷元平
谷月平=谷月平
谷振江=谷振江
谷正文=谷正文
谷祖臣=谷祖臣
谷祖琳=谷祖琳
关岳路=關岳路
广宁路=廣甯路
光岳楼=光岳樓
鬼子姜=鬼子姜
郭卜乐=郭卜樂
国王谷=國王谷
海游路=海游路
海岳楼=海岳樓
侯宁路=侯甯路
胡咸金=胡咸金
环游路=環游路
黄范路=黃范路
皇后台=皇后台
黄梁梦=黃樑夢
黄朴农=黃朴農
灰谷熊=灰谷熊
会宁路=會甯路
徽宁路=徽甯路
几百只=幾百隻
吉卜林=吉卜林
吉卜赛=吉卜賽
济宁华=濟甯華
集宁路=集甯路
济宁路=濟甯路
加速键=快速鍵
碱式盐=鹼式鹽
姜安霞=姜安霞
姜宝林=姜寶林
姜伯华=姜伯華
姜伯静=姜伯靜
姜彩霞=姜彩霞
姜宸英=姜宸英
姜春光=姜春光
姜聪颖=姜聰穎
姜大洪=姜大洪
姜达涛=姜達濤
姜狄江=姜狄江
姜丁丁=姜丁丁
姜定华=姜定華
姜冬青=姜冬青
姜东舒=姜東舒
姜笃安=姜篤安
姜繁智=姜繁智
姜方虹=姜方虹
姜方洲=姜方洲
姜付丛=姜付叢
姜富贵=姜富貴
姜刚强=姜剛強
姜冠华=姜冠華
姜观金=姜觀金
姜管有=姜管有
姜桂成=姜桂成
姜桂凤=姜桂鳳
姜桂芝=姜桂芝
姜国安=姜國安
姜国华=姜國華
姜国静=姜國靜
姜国严=姜國嚴
姜国志=姜國志
姜海文=姜海文
姜海英=姜海英
姜红华=姜紅華
姜红梅=姜紅梅
姜洪权=姜洪權
姜怀龙=姜懷龍
姜惠娜=姜惠娜
姜会庆=姜會慶
姜惠贞=姜惠貞
姜记龙=姜記龍
姜建国=姜建國
姜金晨=姜金晨
姜金凤=姜金鳳
姜金峰=姜金峰
姜金环=姜金環
姜静华=姜靜華
姜景腾=姜景騰
姜净卫=姜淨衛
姜军帅=姜軍帥
姜老庄=姜老莊
姜丽华=姜麗華
姜礼文=姜禮文
姜丽英=姜麗英
姜明华=姜明華
姜明理=姜明理
姜明明=姜明明
姜明月=姜明月
姜乃喻=姜乃喻
姜宁宁=姜甯寧
姜庆虎=姜慶虎
姜庆志=姜慶志
姜人杰=姜人傑
姜日友=姜日友
姜绍华=姜紹華
姜胜国=姜勝國
姜师叔=姜師叔
姜淑华=姜淑華
姜素英=姜素英
姜万发=姜萬發
姜万兴=姜萬興
姜卫超=姜衛超
姜维庆=姜維慶
姜卫忠=姜衛忠
姜夕富=姜夕富
姜席镇=姜席鎮
姜向柯=姜向柯
姜小康=姜小康
姜晓庆=姜曉慶
姜晓燕=姜曉燕
姜修芳=姜修芳
姜修智=姜修智
姜玄洙=姜玄洙
姜叶峰=姜葉峰
江于陈=江于陳
姜宇龙=姜宇龍
姜元武=姜元武
姜岳村=姜嶽村
姜在强=姜在強
姜增营=姜增營
姜占英=姜占英
姜兆强=姜兆強
姜峥嵘=姜崢嶸
姜志平=姜志平
姜志强=姜志強
姜仲圣=姜仲聖
姜周曼=姜周曼
姜庄子=薑莊子
姜自安=姜自安
姜自如=姜自如
姜宗琳=姜宗琳
姜宗月=姜宗月
交换台=交換臺
胶卷轴=膠卷軸
金发亮=金發亮
金谷燕=金谷燕
金余楼=金余樓
尽自己=盡自己
景谷路=景谷路
井里汶=井里汶
静宁苑=靜甯苑
精制伏=精制伏
精制服=精制服
旧历年=舊曆年
卷层云=捲層雲
卡普里=卡普里
科特斯=科迪斯
苛性碱=苛性鹼
空谷兰=空谷蘭
快餐馆=快餐館
拉马尔=拉馬爾
拉面具=拉面具
拉面色=拉面色
拉面罩=拉面罩
老板凳=老板凳
了解除=了解除
了解答=了解答
了解毒=了解毒
了解法=了解法
了解放=了解放
了解救=了解救
了解散=了解散
里埃拉=裡艾拉
历历数=歷歷數
里耶卡=里耶卡
李友余=李友余
李郁强=李郁強
莲岳路=蓮岳路
了解碼=了解碼
辽宁阳=遼寧陽
刘党文=劉党文
刘范弟=劉范弟
六合家=六合家
刘宁富=劉甯富
龙游农=龍游農
仑背乡=崙背鄉
罗宁路=羅甯路
马默里=馬默里
毛发病=毛發病
梅里达=梅里達
孟范友=孟范友
梦谷路=夢谷路
面包庇=面包庇
面包藏=面包藏
面包抄=面包抄
面包裹=面包裹
面包含=面包含
面包涵=面包涵
面包括=面包括
面包容=面包容
棉布线=棉布線
面肥肠=面肥腸
面粉碎=面粉碎
面糊涂=面糊塗
冕宁路=冕甯路
秒表示=秒表示
明镜台=明鏡台
明月台=明月台
墨笔画=墨筆畫
默里克=默里克
默林茂=梅林茂
南谷路=南谷路
南也门=南也門
啮齿目=嚙齒目
宁保人=甯保人
宁厂区=甯廠區
宁城路=甯城路
宁德路=甯德路
宁方端=甯方端
宁方雷=甯方雷
宁方强=甯方強
宁富路=甯富路
宁港路=甯港路
宁谷镇=甯穀鎮
宁广路=甯廣路
宁郭镇=甯郭鎮
宁海荣=甯海榮
宁记麻=甯記麻
宁建农=甯建農
宁金成=甯金成
宁金伟=甯金偉
宁军卫=甯軍衛
宁可可=寧可可
宁克伍=甯克伍
宁郎乡=甯郎鄉
宁老庄=甯老莊
宁雷港=甯雷港
宁丽华=甯麗華
宁立平=甯立平
宁陵关=甯陵關
宁铭成=甯銘成
宁诺宁=甯諾寧
宁其龙=甯其龍
宁桥路=甯橋路
宁尚阳=甯尚陽
宁尚祎=甯尚禕
宁少尉=甯少尉
宁王府=寧王府
宁未来=甯未來
宁文革=甯文革
宁文光=甯文光
宁芜路=甯蕪路
宁西路=甯西路
宁祥路=甯祥路
宁晓贺=甯曉賀
宁彦平=甯彥平
宁扬楚=甯揚楚
宁一平=甯一平
宁永国=甯永國
女儿谷=女兒谷
朴龙河=朴龍河
朴比达=朴比達
朴大阳=朴大陽
朴虎吉=朴虎吉
朴家人=朴家人
朴江秀=朴江秀
朴俊杰=朴俊傑
朴龙达=朴龍達
朴龙宇=朴龍宇
普宁藏=普甯藏
朴奇英=朴奇英
朴万哲=朴萬哲
朴席镇=朴席鎮
朴元国=朴元國
朴在英=朴在英
朴真楼=朴真樓
朴治文=朴治文
朴智运=朴智運
其二只=其二只
戚友余=戚友余
千里子=千裡子
千只夠=千隻夠
千只可=千隻可
乔发乳=喬髮乳
乔纳坦=約拿坦
任伯宁=任伯甯
荣华里=榮華裡
茸宁路=茸甯路
瑞宁路=瑞甯路
散光盘=散光盤
三和弦=三和弦
山宁路=山甯路
上游乡=上遊鄉
少女党=少女党
摄象机=攝像機
伸展台=伸展台
侍御史=侍御史
手表露=手表露
手表面=手表面
手表示=手表示
手表演=手表演
首发式=首發式
舒郁乐=舒郁樂
瞬时值=瞬時值
松口蘑=松口蘑
宋宁宗=宋甯宗
松散剂=松散劑
绥宁路=綏甯路
孙谷棋=孫谷棋
孙均岳=孫均岳
孙凯宁=孫凱甯
孙新宁=孫新甯
孙郁峰=孫郁峰
孙玉宁=孫玉甯
孙于青=孫于青
泰谷路=泰谷路
胎盘片=胎盤片
台子女=台子女
陶卜齐=陶卜齊
淘儿宁=淘兒甯
特制定=特制定
特制止=特制止
腾谷苑=騰谷苑
滕谷苑=滕谷苑
天宁林=天甯林
天宁路=天甯路
天然碱=天然鹼
天山后=天山後
娃娃谷=娃娃谷
娃娃宁=娃娃甯
王余初=王余初
位标识=位元標識
维波里=維波里
位串行=位元串列
位密度=位元密度
喂牲口=餵牲口
唯一只=唯一只
文德里=文德裡
吴伯宁=吳伯甯
五谷丰=五穀豐
五谷米=五穀米
吴岳梁=吳岳梁
嬉游曲=嬉游曲
下咽喉=下咽喉
下咽头=下咽頭
咸淡江=咸淡江
咸红国=咸紅國
咸金枣=咸金棗
咸利平=咸利平
咸宁侯=咸甯侯
咸烧白=咸燒白
咸水草=鹹水草
咸水乡=鹹水鄉
咸水鱼=鹹水魚
咸水珠=鹹水珠
咸田镇=咸田鎮
咸西康=咸西康
咸仲英=咸仲英
乡宁路=鄉甯路
乡宁文=鄉甯文
向往常=向往常
湘岳楼=湘岳樓
谢岳展=謝岳展
新山城=新山城
新山东=新山東
新山西=新山西
新山乡=新山鄉
新郁路=新郁路
形变量=形變量
星伯宁=星伯甯
兴谷乐=興谷樂
行李卷=行李捲
休宁路=休甯路
须根系=須根系
雪宁韦=雪甯韋
雪岳韩=雪岳韓
循环气=循環氣
杨干云=楊干雲
杨岳平=楊岳平
姚岳平=姚岳平
引火线=導火線
阴历年=陰曆年
印台子=印臺子
英雄谷=英雄谷
永宁路=永甯路
游艾迪=游艾迪
游城南=游城南
游婀娜=游婀娜
有计划=有計劃
游嘉杨=游嘉楊
游建平=游建平
游居录=游居錄
游淋妹=游淋妹
游凌飞=游淩飛
游路杰=游路傑
游秘秘=游秘秘
游庆厚=游慶厚
游庆泰=游慶泰
游群芳=游群芳
游素兰=游素蘭
游西池=游西池
游向荣=游向榮
游小平=游小平
悠游居=悠游居
游玉惠=游玉惠
余爱平=余愛平
郁柏其=郁柏其
于宝林=于寶林
余宝周=余寶周
于贝贝=于貝貝
余碧波=余碧波
余碧英=余碧英
余斌文=余斌文
余波峰=余波峰
余彩霞=余彩霞
于彩云=于彩雲
于长春=于長春
于昌江=于昌江
于长梅=于長梅
余昌文=余昌文
于常瑶=于常瑤
余晨光=余晨光
余陈司=余陳司
于成华=于成華
于成妩=于成嫵
于成哉=于成哉
余川尚=余川尚
于春雷=于春雷
余春雷=余春雷
于刺史=于刺史
于丛丛=于叢叢
余翠华=余翠華
于大鲁=于大魯
余道安=余道安
余道江=余道江
余德强=余德強
于德水=于德水
于登权=于登權
余丁乡=余丁鄉
余东风=余東風
于东诸=于東諸
余段乡=余段鄉
鱼儿游=魚兒游
于法兰=于法蘭
余放牛=余放牛
于飞乐=于飛樂
余菲平=余菲平
于飞阳=于飛陽
于丰古=于豐古
郁逢庆=郁逢慶
于丰旭=于豐旭
余凤英=余鳳英
于富昌=于富昌
余福全=余福全
于付涛=于付濤
余甘子=余甘子
于冠华=于冠華
于管家=于管家
余关乡=余關鄉
于管营=于管營
余光兰=余光蘭
余光明=余光明
于桂香=于桂香
于国峰=于國峰
于国红=于國紅
余国瑞=余國瑞
于国诗=于國詩
余国松=余國松
于国潇=于國瀟
于海丰=于海豐
于海鸥=于海鷗
于海平=于海平
余汉林=余漢林
愈合乎=愈合乎
于贺龙=于賀龍
余宏伟=余宏偉
于宏阳=于宏陽
于化雷=于化雷
余化龙=余化龍
于惠玲=于惠玲
余慧文=余慧文
余季平=余季平
于家水=于家水
于家庄=于家莊
余健儿=余健兒
余建国=余建國
余剑华=余劍華
余建龙=余建龍
余建平=余建平
余建文=余建文
于姜伟=于薑偉
于锦达=于錦達
余金明=余金明
余金荣=余金榮
余景洪=余景洪
于景连=于景連
郁经路=郁經路
于敬业=于敬業
余井镇=余井鎮
余居士=余居士
于君方=于君方
于俊杰=于俊傑
余开吉=余開吉
余康铭=余康銘
于克文=于克文
余奎廉=余奎廉
于堃江=于堃江
于坤梅=于坤梅
于昆明=于昆明
于腊梅=于臘梅
于立成=于立成
余立江=余立江
于黎黎=于黎黎
于黎明=于黎明
于李宁=于李寧
余梁海=余梁海
于凌波=于淩波
于凌飞=于淩飛
于凌燕=于淩燕
于灵燕=于靈燕
于鲁华=于魯華
于陆军=于陸軍
余路通=余路通
于鲁燕=于魯燕
于懋林=于懋林
余美娘=余美娘
于美英=于美英
余美英=余美英
余孟春=余孟春
余孟杰=余孟傑
余孟涛=余孟濤
于米特=于米特
于绵林=于綿林
于苗苗=于苗苗
于明珠=于明珠
于谋侠=于謀俠
于南村=于南村
余胖子=余胖子
余佩英=余佩英
余婆婆=余婆婆
于桥周=于橋周
余青年=余青年
于全兴=于全興
余任天=余任天
余润泽=余潤澤
于思荣=于思榮
余森林=余森林
郁善房=郁善房
于上周=于上周
余少华=余少華
余绍宋=余紹宋
余邵鱼=余邵魚
于沈潼=于沈潼
于盛军=于盛軍
余圣康=余聖康
余胜强=余勝強
于氏梅=于氏梅
于世平=于世平
余石水=余石水
于寿静=于壽靜
余守平=余守平
余寿湘=余壽湘
于曙光=于曙光
余叔岩=余叔岩
余顺平=余順平
余思路=余思路
余苏梅=余蘇梅
于塘路=于塘路
于天明=于天明
余天戚=余天戚
余田乡=余田鄉
余挺国=余挺國
于婷婷=于婷婷
于同江=于同江
于万碧=于萬碧
于万亭=于萬亭
余韦宝=余韋寶
于未房=于未房
余伟华=余偉華
于卫卫=于衛衛
余慰祖=余慰祖
于稳林=于穩林
余五安=余五安
余武斌=余武斌
余武基=余武基
于喜龙=于喜龍
余习胜=余習勝
余仙英=余仙英
于向斌=于向斌
于相龙=于相龍
于晓华=于曉華
于晓江=于曉江
于小姐=于小姐
余小兰=余小蘭
余晓梅=余曉梅
于小乔=于小喬
于孝文=于孝文
余肖勇=余肖勇
余新燕=余新燕
于辛庄=于辛莊
于兴华=于興華
于秀丽=于秀麗
于修龙=于修龍
余旭阳=余旭陽
于学成=于學成
于学林=于學林
余雪梅=余雪梅
于雪燕=于雪燕
余亚南=余亞南
于亚平=于亞平
余亚平=余亞平
余燕飞=余燕飛
余艳华=余豔華
余燕华=余燕華
余艳丽=余豔麗
余燕玲=余燕玲
余燕苹=余燕蘋
余燕青=余燕青
郁颜旭=郁顏旭
于一侠=于一俠
于奕正=于奕正
余殷华=余殷華
于印宁=于印寧
于永帅=于永帥
郁友达=郁友達
于幼华=于幼華
余友金=余友金
余友文=余友文
余元林=余元林
余园龙=余園龍
于跃林=于躍林
于月平=于月平
于在池=于在池
于章龙=于章龍
余朝晖=余朝暉
于振龙=于振龍
余振玄=余振玄
余正林=余正林
于志安=于志安
于志方=于志方
于志高=于志高
于志金=于志金
余之妻=余之妻
余致强=余致強
余智威=余智威
于忠华=于忠華
余仲华=余仲華
余中坚=余中堅
于主任=于主任
于庄子=於莊子
余梓梁=余梓梁
余宗墩=余宗墩
于宗贵=于宗貴
于宗奎=于宗奎
余祖宏=余祖宏
余作帅=余作帥
圆括号=圓括號
园宁路=園甯路
元宁宗=元甯宗
岳巴乡=岳巴鄉
岳伯川=岳伯川
岳财富=岳財富
岳彩文=岳彩文
岳常圆=岳常圓
岳超群=岳超群
岳冬梅=岳冬梅
岳高頭=岳高頭
岳国胜=岳國勝
岳洪彬=岳洪彬
岳湖楼=岳湖樓
岳继卫=岳繼衛
岳家务=嶽家務
岳丽蒙=岳麗蒙
岳利民=岳利民
岳平花=岳平花
岳秋龙=岳秋龍
岳上岳=岳上嶽
岳胜利=岳勝利
岳宋乡=岳宋鄉
岳天池=岳天池
岳万华=岳萬華
岳文秀=岳文秀
岳湘华=岳湘華
岳小春=岳小春
岳小荣=岳小榮
岳学艺=岳學藝
岳亚燕=岳亞燕
岳一平=岳一平
岳友河=岳友河
岳玉强=岳玉強
岳张集=岳張集
岳智军=岳智軍
岳仲秋=岳仲秋
岳州路=岳州路
岳宗博=岳宗博
云谷路=雲谷路
增谷路=增谷路
战船台=戰船台
占有数=占有數
展转食=輾轉食
这出戏=這齣戲
贞卜文=貞卜文
证明了=證明了
整天价=整天价
只身材=只身材
只身段=只身段
只身份=只身份
只身旁=只身旁
只身世=只身世
只身受=只身受
只身心=只身心
只身形=只身形
只身影=只身影
只身子=只身子
之一只=之一只
制音器=製音器
中宁路=中甯路
朱宁兰=朱甯蘭
诸岳富=諸岳富
字于宫=字于宮
紫岳文=紫岳文
自制伏=自制伏
自制服=自制服
阿迪达斯=愛迪達
阿莫鲁索=阿莫盧梭
阿斯塔纳=阿斯坦納
埃德蒙顿=埃德蒙頓
安全通道=秘密頻道
安全信息=安全資訊
奥古斯丁=奥古斯丁
巴尔扎克=巴爾扎克
拔苗助长=揠苗助長
百里挑一=百裡挑一
白面书生=白面書生
版本信息=版本資訊
保存文件=保存檔
保留剧目=保留劇目
比较数据=比較資料
标准偏差=標準差
别别扭扭=彆彆扭扭
博采众长=博採眾長
播放列表=播放清單
布尔乔亚=布爾喬亞
不干不净=不乾不淨
不寒而栗=不寒而慄
布里斯班=布里斯班
卜筮正宗=卜筮正宗
不知所云=不知所云
才高八斗=才高八斗
财务数据=財務資料
财务信息=財務資訊
藏垢纳污=藏垢納污
测量数据=測量資料
测试数据=測試資料
插入数据=插入資料
产品信息=產品資訊
车载斗量=車載斗量
程序文件=程式檔
持之以恒=持之以恆
冲昏头脑=衝昏頭腦
除旧布新=除舊佈新
出租汽车=計程車
传递信息=傳遞資訊
传送文件=傳送檔
窗明几净=窗明几淨
磁盘空间=磁碟空間
粗制滥造=粗製濫造
措施项目=措施專案
错误信息=錯誤資訊
大啊啊啊=大啊啊啊
大谷育江=大谷育江
大宁国际=大寧國際
代理协议=代理協定
党的建设=党的建設
党的领导=党的領導
荡气回肠=盪氣迴腸
党要管党=党要管黨
党指挥枪=党指揮槍
得而复失=得而復失
的黎波里=的黎波里
第二性征=第二性征
地理信息=地理資訊
店铺信息=店鋪資訊
电子货币=電子錢
电子文件=電子檔
电子信息=電子資訊
雕梁画栋=雕樑畫棟
雕梁画柱=雕樑畫柱
吊民伐罪=弔民伐罪
独辟蹊径=獨闢蹊徑
独占鳌头=獨佔鰲頭
对比文件=對比檔
对话窗口=對話視窗
多米尼克=多明尼克
恶性循环=惡性循環
二手电脑=二手電腦
发布信息=發佈資訊
法律文件=法律檔
范大将军=范大將軍
范德华力=范德華力
反馈信息=回饋資訊
房产信息=房產資訊
费迪南德=斐迪南
飞短流长=蜚短流長
分类信息=分類資訊
分配制度=分配制度
分支机构=分支機搆
峰回路转=峰迴路轉
风卷残云=風捲殘雲
佛罗里达=佛羅里達
釜底游鱼=釜底游魚
复合元音=複合元音
附加信息=附加資訊
弗朗西斯=法蘭西斯
俯首帖耳=俯首貼耳
服务对象=服務物件
辅助功能=協助工具
干干净净=乾乾淨淨
干劲冲天=幹勁衝天
格里菲斯=格里菲斯
个人信息=個人資訊
歌舞升平=歌舞昇平
更仆难数=更仆難數
工程塑料=工程塑料
共享文件=共用檔
工艺文件=工藝檔
工作日志=工作日志
谷村新司=谷村新司
谷歌翻译=谷歌翻譯
谷胱甘肽=谷胱甘肽
谷贱伤农=谷賤傷農
故态复萌=故態復萌
谷原章介=谷原章介
挂一漏万=挂一漏萬
管理信息=管理資訊
管宁割席=管甯割席
光谷大道=光谷大道
国家信息=國家資訊
国王之谷=國王之谷
哈密尔顿=漢米爾頓
海宁皮城=海甯皮城
咳声叹气=唉聲嘆氣
还在线呢=還在線呢
航天飞机=太空梭
航天信息=航太資訊
豪气干云=豪氣干雲
河涸海干=河涸海乾
合伙协议=合夥協定
河外星系=銀河外星系
横冲直闯=橫衝直撞
横冲直撞=橫衝直撞
横征暴敛=橫徵暴斂
红头文件=紅頭文件
呼叫转移=來電轉接
呼朋引类=呼朋引伴
回肠荡气=迴腸盪氣
回光返照=迴光返照
会计信息=會計資訊
魂牵梦系=魂牽夢繫
基本信息=基本資訊
集成电路=積體電路
基础信息=基礎資訊
计划经济=計劃經濟
计划生育=計劃生育
基建项目=基建專案
基里巴斯=吉里巴斯
技术文件=技術檔
家长里短=家長里短
甲状软骨=甲狀輭骨
间不容发=間不容髮
建宁公主=建甯公主
交通警察=交通警察
结婚对象=結婚物件
解铃系铃=解鈴繫鈴
津巴布韦=辛巴威
进退维谷=進退維谷
紧追不舍=緊追不捨
经济数据=經濟資料
经济信息=經濟資訊
就业信息=就業資訊
九游游戏=九遊遊戲
居里夫人=居里夫人
举手表决=舉手表決
具体项目=具體專案
卷土重来=捲土重來
君子不党=君子不党
君子于役=君子于役
卡利亚里=卡利亞里
开诚布公=開誠佈公
开天辟地=開天闢地
客户信息=客戶資訊
克己复礼=克己復禮
科技信息=科技資訊
克罗地亚=克羅埃西亞
科罗拉多=科羅拉多
科特迪瓦=象牙海岸
科研项目=科研專案
空谷幽兰=空谷幽蘭
空谷足音=空谷足音
控制成本=控制成本
控制面板=控制台
口干舌燥=口乾舌燥
口干咽燥=口乾咽燥
口血未干=口血未乾
库存盘点=庫存盤點
夸父逐日=夸父追日
夸父追日=夸父追日
琅勃拉邦=瑯勃拉邦
浪潮信息=浪潮資訊
狼吞虎咽=狼吞虎嚥
利伯维尔=自由市
历史数据=歷史資料
利欲熏心=利慾薰心
链接地址=連結位址
恋恋不舍=戀戀不捨
两栖动物=兩棲動物
梁上君子=樑上君子
辽宁成大=遼寧成大
列克星敦=列克星敦
临渊羡鱼=臨淵羡魚
另辟蹊径=另闢蹊徑
溜须拍马=溜鬚拍馬
乱发脾气=亂發脾氣
罗马里奥=羅馬裡奧
罗切斯特=羅切斯特
马尔萨斯=馬爾薩斯
满坑满谷=滿坑滿谷
漫游生物=漫游生物
茅山后裔=茅山後裔
蒙头转向=矇頭轉向
梦游先生=夢游先生
密苏里州=密蘇里州
渺无人烟=杳無人煙
模范马路=模範馬路
墨迹未干=墨蹟未乾
模拟电路=類比電路
模拟电子=類比電子
模拟软件=類比軟體
模拟信号=類比信號
莫桑比克=莫三比克
墨索里尼=墨索里尼
难割难舍=難割難捨
南京信息=南京資訊
难舍难分=難捨難分
年复一年=年復一年
怒发冲冠=怒髮衝冠
怒气冲天=怒氣衝天
庞蒂亚克=皮蒂亞克
旁征博引=旁徵博引
泡沫塑料=泡沫塑料
抛头露面=抛頭露面
抛砖引玉=抛磚引玉
劈里啪啦=劈里啪啦
披头散发=披頭散髮
片言只语=片言隻語
乒乓球台=乒乓球台
破口大骂=破口大駡
朴茨茅斯=朴茨茅斯
铺盖卷儿=鋪蓋捲兒
气冲牛斗=氣沖牛斗
气冲霄汉=氣衝霄漢
其他信息=其他資訊
前紧后松=前緊後鬆
千钧一发=千鈞一髮
前仆后继=前仆後繼
锲而不舍=鍥而不捨
亲水平台=親水準台
青出于蓝=青出於藍
情有独钟=情有獨鍾
穷追不舍=窮追不捨
鹊巢鸠占=鵲巢鳩佔
人机界面=人機界面
人民警察=人民警察
人寿年丰=人夀年豐
人云亦云=人云亦云
日程安排=排程
日复一日=日復一日
乳臭未干=乳臭未乾
撒啊啊啊=撒啊啊啊
萨拉热窝=塞拉耶佛
撒马尔罕=撒馬爾罕
塞浦路斯=賽普勒斯
散兵游勇=散兵游勇
商品信息=商品資訊
舍本逐末=捨本逐末
舍己救人=捨己救人
舍己为公=捨己為公
舍己为人=捨己為人
设计文件=設計檔
舍近求远=捨近求遠
舍生取义=捨生取義
舍生忘死=捨生忘死
舍死忘生=捨死忘生
神谷浩史=神谷浩史
什么文件=什麼檔
生长发育=生長發育
圣路易斯=聖路易斯
生物武器=生化武器
生物信息=生物資訊
史蒂文森=史蒂文生
失而复得=失而復得
始建于唐=始建于唐
时紧时松=時緊時鬆
视频地址=視頻位址
视频剪辑=視訊短片
尸位素餐=尸位素餐
首当其冲=首當其衝
收到信息=收到資訊
鼠标指针=滑鼠指標
数据采集=資料獲取
数据处理=資料處理
数据存储=資料存儲
数据分析=資料分析
数据恢复=資料恢復
数据接口=資料介面
数据来源=資料來源
数据连接=資料連接
数据录入=資料錄入
数据收集=資料收集
数据统计=資料統計
数据挖掘=資料採擷
数据维护=資料維護
数据显示=資料顯示
数据业务=資料業務
数据整理=資料整理
数据中心=資料中心
输入设备=輸入裝置
输入数字=輸入數位
数字电视=數位電視
数字逻辑=數位邏輯
数字签名=數位簽章
数字时钟=數位時鐘
数字通信=數位通信
数字相机=數位相機
数字证书=數位憑證
死而复生=死而復生
死灰复燃=死灰復燃
斯里兰卡=斯里蘭卡
四舍五入=四捨五入
松松垮垮=鬆鬆垮垮
松松散散=鬆鬆散散
松赞干布=松贊干布
苏宁易购=蘇甯易購
苏宁云商=蘇甯雲商
太聪明了=太聰明了
贪官污吏=貪官污吏
叹观止矣=嘆觀止矣
坛坛罐罐=罎罎罐罐
体检项目=體檢專案
提示信息=提示資訊
天干物燥=天乾物燥
亭台楼阁=亭臺樓閣
统计数据=統計資料
统计信息=統計資訊
同流合污=同流合污
通天干探=通天幹探
偷梁换柱=偷樑換柱
图书信息=圖書資訊
唾面自干=唾面自乾
外强中干=外強中乾
万方数据=萬方資料
网络信息=網路資訊
望洋兴叹=望洋興嘆
未卜先知=未卜先知
未可厚非=無可厚非
位置信息=位置資訊
文件传输=檔案傳輸
文件加密=檔加密
文件精神=檔精神
文件目录=檔目錄
温切斯特=溫徹斯特
文字处理=文字處理
瓮中之鳖=甕中之鼈
瓮中捉鳖=甕中捉鼈
我的主页=我的首頁
卧薪尝胆=臥薪嚐膽
物理地址=物理位址
五年计划=五年計劃
污水处理=汙水處理
乌苏里江=烏蘇里江
舞台灯光=舞臺燈光
无线数据=無線資料
污言秽语=污言穢語
无以复加=無以復加
细嚼慢咽=細嚼慢嚥
系统文件=系統檔
系统信息=系統資訊
西游战记=西游戰記
西岳华山=西嶽華山
下里巴人=下里巴人
下面一点=下面一點
咸蛋超人=咸蛋超人
咸嘉新村=咸嘉新村
限位开关=限位元開關
闲言碎语=閒言碎語
闲言闲语=閒言閒語
咸与维新=咸與維新
相关数据=相關資料
相关文件=相關檔
项目工作=專案工作
项目计划=專案計畫
项目经费=專案經費
项目开发=專案開發
项目实施=專案實施
项目信息=專案資訊
项目执行=專案執行
项目资金=專案資金
相生相克=相生相剋
详细信息=詳細資訊
销售信息=銷售資訊
笑逐颜开=笑顏逐開
歇斯底里=歇斯底里
协议内容=協定內容
心广体胖=心寬體胖
心理发展=心理發展
信息安全=資訊安全
信息采集=資訊採集
信息产业=資訊產業
信息处理=資訊處理
信息传递=資訊傳遞
信息大厦=資訊大廈
信息发布=資訊發佈
信息发送=資訊發送
信息反馈=資訊回饋
信息服务=資訊服務
信息工程=資訊工程
信息公开=資訊公開
信息共享=資訊共用
信息管理=資訊管理
信息技术=資訊技術
信息检索=資訊檢索
信息交流=資訊交流
信息科技=資訊科技
信息科学=資訊科學
信息披露=資訊披露
信息平台=資訊平臺
信息时报=資訊時報
信息时代=資訊時代
信息收集=資訊收集
信息统计=資訊統計
信息网络=資訊網路
信息系统=資訊系統
信息中心=資訊中心
信息咨询=資訊諮詢
信息资源=資訊資源
形单影只=形單影隻
星罗棋布=星羅棋佈
星移斗转=星移斗轉
形影相吊=形影相弔
凶神恶煞=兇神惡煞
凶相毕露=兇相畢露
虚怀若谷=虛懷若谷
虚假信息=虛假資訊
旭日东升=旭日東昇
血浓于水=血濃於水
学生信息=學生資訊
学习文件=學習檔
学习用品=學習用品
循环往复=循環往復
循环系统=循環系統
亚历山大=亞歷山大
眼观四路=眼觀四面
烟熏火燎=煙薰火燎
阳谷华泰=陽谷華泰
页面布局=頁面配置
也说明了=也說明了
液位开关=液位元開關
一发千钧=一髮千鈞
一干二净=一乾二淨
一个文件=一個檔
伊利诺伊=伊利諾
伊斯兰堡=伊斯蘭馬巴德
医学信息=醫學資訊
依依不舍=依依不捨
异于常人=異于常人
伊于胡底=伊于胡底
一只眼睛=一隻眼睛
抑制作用=抑制作用
引火烧身=引火焚身
吟游诗人=吟游詩人
阴云密布=烏雲密佈
映像文件=映射檔
用户界面=使用者介面
用户信息=使用者資訊
游必有方=游必有方
游标卡尺=遊標卡尺
游枷利叶=游枷利葉
有鉴于此=有鑑於此
游就游吧=游就遊吧
游来游去=游來遊去
游目四顾=游目四顧
游手好闲=遊手好閒
游闲公子=游閑公子
有效信息=有效資訊
游游荡荡=遊遊蕩蕩
悠游自在=悠游自在
于国于民=于國於民
寓教于乐=寓教於樂
寓情于景=寓情于景
于情于理=于情於理
玉汝于成=玉汝于成
御史大夫=御史大夫
余氏东风=余氏東風
于斯为盛=于斯為盛
于意云何=于意雲何
余荫山房=余蔭山房
余勇可贾=余勇可賈
鱼游釜中=魚游釜中
远程访问=遠端存取
远程教育=遠端教育
远程控制=遠程控制
远程连接=遠端連接
原始数据=原始資料
岳麓大道=岳麓大道
赞不绝口=讚不絕口
扎扎实实=扎扎實實
债台高筑=債臺高築
张灯结彩=張燈結綵
招标项目=招標專案
招聘信息=招聘資訊
震古烁今=震古鑠今
政府信息=政府資訊
政务信息=政務資訊
指鸡骂狗=指雞駡狗
直角坐标=直角坐標
质量信息=品質資訊
智能交通=智慧交通
智能控制=智慧控制
智能系统=智慧系統
智能语音=智慧語音
智能终端=智慧終端機
指桑骂槐=指桑駡槐
知识分子=知識份子
只手遮天=隻手遮天
只言片语=隻言片語
止于智者=止于智者
秩秩斯干=秩秩斯干
重点项目=重點專案
周而复始=周而復始
注册商标=注冊商標
准备考研=准備考研
擢发难数=擢髮難數
子丑寅卯=子丑寅卯
子网掩码=子網路遮罩
资源共享=資源分享
租赁协议=租賃協定
巴埃灯鳉=﻿巴埃燈鱂
百谷之王=百谷之王
柏宁大厦=柏甯大廈
白日作梦=做白日夢
白岳黄芽=白岳黃芽
百只足夠=百隻足夠
班伯里联=班伯里聯
板谷由夏=板谷由夏
伴游小姐=伴游小姐
邦宁沙吉=邦甯沙吉
爆发指数=爆發指數
保密信息=保密資訊
保宁半夏=保甯半夏
包销协议=包銷協定
备份文件=備份檔案
北周六典=北周六典
比亚里茨=比亞里茨
必作于易=必作于易
编解码器=轉碼器
扁平电缆=排線
变质量系=變質量系
表面点火=表面點火
表面条件=表面條件
标准对象=標準物件
标准文件=標準檔
别范安成=別范安成
并联系统=並聯系統
并行传输=平行傳輸
并行计算=平行計算
并行数据=並行資料
病于夏畦=病于夏畦
伯恩茅斯=伯恩第斯
剥极必复=剝極必復
卜家庄乡=卜家莊鄉
博士多宁=博士多甯
卜夜卜昼=卜夜蔔晝
布尔格斯=布爾格斯
布尔运算=布耳運算
部分进位=部分進位元
不拘于时=不拘于時
布拉干萨=布拉干薩
布里奇顿=橋鎮
补炉料斗=補爐料鬥
不予支持=不予支援
不止于万=不止于萬
卜昼卜夜=卜晝蔔夜
被发缨冠=被髮纓冠
被发左衽=被髮左衽
采风问俗=採風問俗
菜品质量=菜品質量
彩屏干版=彩屏乾版
彩秀美发=彩秀美發
苍黄翻复=蒼黃翻覆
测试响应=測試響應
层峦迭嶂=層巒疊嶂
查尔斯顿=查爾斯頓
叉管制作=叉管制作
昌发油脂=昌發油脂
长谷川步=長谷川步
长元音符=長元音符
朝崎郁惠=朝崎郁惠
成像素质=成像素質
赤绳系足=赤繩繫足
崇岳禅师=崇岳禪師
抽样数据=抽樣資料
出谷黄莺=出谷黃鶯
出谷迁乔=出谷遷喬
初始对象=初始物件
出于林中=出於林中
串联系统=串聯系統
传输信息=傳輸資訊
串行端口=序列埠
窗口函数=視窗函數
窗口作用=視窗作用
创作空间=﻿創作空間
磁性固位=磁性固位元
词语信息=詞語資訊
脆皮面包=脆皮面包
存亡未卜=存亡未卜
大谷大学=大谷大學
大谷美纪=大谷美紀
大谷石佛=大谷石佛
大谷太郎=大谷太郎
大面市场=大面市場
打漂游儿=打漂游兒
大曲菌素=大麴菌素
代理发行=代理發行
单处理器=單一處理器
丹郁骨康=丹郁骨康
档案文件=檔案檔
党坚势盛=党堅勢盛
党留庄乡=党留莊鄉
得克萨斯=德克薩斯
登录脚本=登入指令檔
地域类型=地欄位型別
地址掩码=位址遮罩
地址映射=位址映射
电报数据=電報資料
点只功夫=點隻功夫
跌荡不羁=跌盪不羈
跌荡不拘=跌盪不拘
跌荡风流=跌盪風流
丁宁深意=丁甯深意
东慕谷韩=東慕谷韓
东宁卫乡=東甯衛鄉
东游丛录=東游叢錄
斗转参横=斗轉參橫
独挡一面=獨當一面
独立户口=獨立戶口
笃于时也=篤于時也
断发文身=斷髮文身
对象模型=物件模型
对象字典=物件字典
多边协议=多邊協定
多道程序=多道程序
多余信息=多餘資訊
而百姓宁=而百姓甯
二谷理惠=二谷理惠
二进制位=二進位位元
发明信息=發明資訊
发卡银行=發卡銀行
法师处咸=法師處咸
法师仁岳=法師仁岳
法师咸润=法師咸潤
法师与咸=法師與咸
伐树于宋=伐樹于宋
范埃伊登=范埃伊登
范布克林=范布克林
范德古恩=范德古恩
范德梅德=范德梅德
范德沙夫=范德沙夫
范德夏夫=范德夏夫
范登博雷=范登博雷
范登伊德=范登伊德
范丁特尔=范丁特爾
范费塞姆=范費塞姆
翻复无常=翻覆無常
范哥特姆=范哥特姆
范海弗滕=范海弗滕
泛黄发花=泛黃發花
范霍维伦=范霍維倫
范家庄乡=范家莊鄉
范米尔洛=范米爾洛
范穆里克=范穆裡克
反舍于鲁=反舍于魯
范田纱纱=范田紗紗
范徐丽泰=范徐麗泰
反于帝宫=反于帝宮
范张鸡黍=范張雞黍
费用项目=費用專案
费用信息=費用資訊
非尊于齐=非尊于齊
分发指令=分發指令
分类项目=分類專案
酚醛塑料=酚醛塑料
凤巢七层=﻿鳳巢七層
丰宁管业=豐甯管業
丰宁原始=豐寧原始
丰台北路=豐台北路
符号智能=符號智慧
附加协议=附加協定
附加载荷=附加載荷
弗里波特=弗里波特
父母于子=父母于子
福宁大厦=福甯大廈
附图标记=附圖標記
赋值语句=設定陳述式
陔余丛考=陔余叢考
干巴利脆=乾巴利脆
感光干版=感光乾版
干卿底事=干卿底事
干云蔽日=乾雲蔽日
高对比度=高對比
各个组件=各個元件
个股分析=個股分析
葛谷叶子=葛谷葉子
戈亚斯城=戈阿斯城
工程控制=工程控制
拱桥台身=拱橋台身
工艺程序=工藝程序
工作队列=工作隊列
工作数据=工作資料
谷川理沙=谷川理沙
谷达坡乡=谷達坡鄉
谷父蚕母=谷父蠶母
谷宫悌二=谷宮悌二
谷宫绚子=谷宮絢子
古谷芳香=古谷芳香
古谷沙织=古谷沙織
谷家营村=谷家營村
谷金楼乡=谷金樓鄉
谷糠太林=谷糠太林
谷口麻美=谷口麻美
谷罗山乡=谷羅山鄉
谷马砺兵=谷馬礪兵
谷美靓汤=谷美靚湯
沽名干誉=沽名干譽
股票信息=股票資訊
谷山纪章=谷山紀章
谷神同道=谷神同道
谷盛农资=谷盛農資
谷宋巨子=谷宋鉅子
谷穗黄了=谷穗黃了
谷威米业=谷威米業
谷围新村=谷圍新村
谷秀年丰=谷秀年豐
古岳宗亘=古岳宗亙
故障模拟=故障類比
关系代数=關聯代數
归档文件=歸檔檔
鬼谷道士=鬼谷道士
过于平稳=過於平穩
果于自信=果于自信
海岳大厦=海岳大廈
海岳名言=海岳名言
韩佳宁韩=韓佳甯韓
合作协议=合作協定
黑谷友香=黑谷友香
洪范池镇=洪范池鎮
洪炉燎发=洪爐燎髮
红绳系足=紅繩繫足
洪岳宗演=洪岳宗演
侯服于周=侯服于周
厚朴温中=厚朴溫中
后台任务=幕後工作
侯于周服=侯于周服
胡里胡涂=糊裡糊塗
胡涂福星=糊塗福星
胡涂太太=糊塗太太
互相干擾=互相幹擾
画栋雕梁=畫棟雕樑
啊啊啊啊=啊啊啊啊
啊啊哈哈=啊啊哈哈
阿布扎比=阿布達比
阿莫鲁索=阿莫盧梭
阿塞拜疆=亞塞拜然
阿雅克肖=阿雅丘
埃德蒙顿=埃德蒙頓
爱憎分明=愛恨分明
安全信息=安全資訊
奥古斯丁=奥古斯丁
巴巴多斯=巴貝多
巴尔扎克=巴爾扎克
拔苗助长=揠苗助長
巴塞罗那=巴賽隆納
百里挑一=百裡挑一
白面书生=白面書生
版本信息=版本資訊
保存文件=保存檔
保留剧目=保留劇目
奔走相告=奔相走告
比什凯克=比斯凱克
别别扭扭=彆彆扭扭
博采众长=博採眾長
博茨瓦纳=波札那
玻利瓦尔=玻利瓦爾省
布尔乔亚=布爾喬亞
不干不净=不乾不淨
不寒而栗=不寒而慄
布拉德利=布蘭得利
布里斯班=布里斯班
卜筮正宗=卜筮正宗
不知所云=不知所云
才高八斗=才高八斗
财务数据=財務資料
财务信息=財務資訊
参考数据=參考資料
藏垢纳污=藏垢納污
操作系统=作業系統
测量数据=測量資料
测试数据=測試資料
插入数据=插入資料
产品信息=產品資訊
车载斗量=車載斗量
程序代码=程式碼
持之以恒=持之以恆
冲昏头脑=衝昏頭腦
除旧布新=除舊佈新
处理程序=處理常式
出租汽车=計程車
传递信息=傳遞資訊
传输数据=傳輸資料
传送文件=傳送檔
窗明几净=窗明几淨
磁盘空间=磁碟空間
磁盘阵列=磁碟陣列
粗制滥造=粗製濫造
存储设备=存放裝置
错误信息=錯誤資訊
大啊啊啊=大啊啊啊
大谷育江=大谷育江
大宁国际=大寧國際
打印预览=預覽列印
党的建设=党的建設
党的领导=党的領導
荡气回肠=盪氣迴腸
党要管党=党要管黨
党指挥枪=党指揮槍
道听途说=道聼塗説
得而复失=得而復失
的黎波里=的黎波里
第二性征=第二性征
地理信息=地理資訊
点击链接=點選連結
店铺信息=店鋪資訊
电子表格=試算表
电子数据=電子資料
电子信息=電子資訊
雕梁画栋=雕樑畫棟
雕梁画柱=雕樑畫柱
吊民伐罪=弔民伐罪
独辟蹊径=獨闢蹊徑
独占鳌头=獨佔鰲頭
对比文件=對比檔
对话窗口=對話視窗
多米尼加=多明尼加
恶性循环=惡性循環
嗯啊啊啊=嗯啊啊啊
二进制数=二進位數字
二手电脑=二手電腦
发布信息=發佈資訊
法律文件=法律檔
范大将军=范大將軍
范德华力=范德華力
反馈信息=回饋資訊
房产信息=房產資訊
访问权限=存取權限
飞短流长=蜚短流長
菲尼克斯=費尼克斯
分类信息=分類資訊
分配制度=分配制度
分支机构=分支機搆
峰回路转=峰迴路轉
风卷残云=風捲殘雲
佛罗里达=佛羅里達
佛罗伦萨=佛羅倫斯
釜底游鱼=釜底游魚
福尔马林=福馬林
复合元音=複合元音
弗吉尼亚=維吉尼亞
附加信息=附加資訊
富兰克林=佛蘭克林
弗洛伊德=佛洛德
复位电路=重定電路
服务项目=服務專案
干干净净=乾乾淨淨
干劲冲天=幹勁衝天
高级语言=高階語言
格里菲斯=格里菲斯
格林纳达=格瑞那達
个人信息=個人資訊
歌舞升平=歌舞昇平
更仆难数=更仆難數
攻城略地=攻城掠地
工程塑料=工程塑料
共享文件=共用檔
工艺文件=工藝檔
工作日志=工作日志
勾股定理=畢氏定理
谷村新司=谷村新司
谷歌翻译=谷歌翻譯
谷胱甘肽=谷胱甘肽
谷贱伤农=谷賤傷農
故态复萌=故態復萌
谷原章介=谷原章介
挂一漏万=挂一漏萬
管理信息=管理資訊
管宁割席=管甯割席
光谷大道=光谷大道
过程控制=程序控制
国家信息=國家資訊
国王之谷=國王之谷
过眼烟云=過眼雲煙
海宁皮城=海甯皮城
咳声叹气=唉聲嘆氣
还在线呢=還在線呢
汉语拼音=中文拼音
航天信息=航太資訊
豪气干云=豪氣干雲
核反应堆=核反應爐
河涸海干=河涸海乾
合伙协议=合夥協定
赫鲁晓夫=赫魯雪夫
横冲直闯=橫衝直撞
横冲直撞=橫衝直撞
横征暴敛=橫徵暴斂
宏昌电子=巨集昌電子
红头文件=紅頭文件
后台程序=幕後程式
呼朋引类=呼朋引伴
汇编语言=組合語言
回肠荡气=迴腸盪氣
回光返照=迴光返照
会计信息=會計資訊
魂牵梦系=魂牽夢繫
霍格沃茨=霍格華茲
基本信息=基本資訊
即插即用=隨插即用
基础数据=基礎資料
基础信息=基礎資訊
吉尔伯特=吉伯特
计划经济=計劃經濟
计划生育=計劃生育
基建项目=基建專案
基金项目=基金專案
技术文件=技術檔
技术支持=技術支援
家长里短=家長里短
加拉加斯=卡拉卡斯
甲状软骨=甲狀輭骨
间不容发=間不容髮
建宁公主=建甯公主
交通警察=交通警察
结婚对象=結婚物件
解铃系铃=解鈴繫鈴
介绍对象=介紹物件
进退维谷=進退維谷
紧追不舍=緊追不捨
经济数据=經濟資料
经济信息=經濟資訊
就业信息=就業資訊
九游游戏=九遊遊戲
局部变量=區域變數
居里夫人=居里夫人
举手表决=舉手表決
具体地址=具體位址
卷土重来=捲土重來
君子不党=君子不党
君子于役=君子于役
卡利亚里=卡利亞里
卡斯特罗=卡斯楚
开诚布公=開誠佈公
开卷有益=開券有益
开天辟地=開天闢地
康涅狄格=康乃狄克
客户信息=客戶資訊
克己复礼=克己復禮
科技信息=科技資訊
克里斯蒂=克利斯蒂
科罗拉多=科羅拉多
克什米尔=喀什米爾
科研项目=科研專案
可移植性=可攜性
空谷幽兰=空谷幽蘭
空谷足音=空谷足音
控制成本=控制成本
控制面板=控制台
口干舌燥=口乾舌燥
口干咽燥=口乾咽燥
口血未干=口血未乾
库存盘点=庫存盤點
夸父逐日=夸父追日
夸父追日=夸父追日
宽带连接=寬頻連線
琅勃拉邦=瑯勃拉邦
浪潮信息=浪潮資訊
狼吞虎咽=狼吞虎嚥
利比里亚=賴比瑞亞
历史数据=歷史資料
利欲熏心=利慾薰心
连接超时=連接逾時
恋恋不舍=戀戀不捨
两栖动物=兩棲動物
梁上君子=樑上君子
辽宁成大=遼寧成大
了如指掌=瞭若指掌
列克星敦=列克星敦
临时文件=暫存檔案
临渊羡鱼=臨淵羡魚
另辟蹊径=另闢蹊徑
溜须拍马=溜鬚拍馬
乱发脾气=亂發脾氣
罗马里奥=羅馬裡奧
罗切斯特=羅切斯特
马尔代夫=馬爾地夫
马尔萨斯=馬爾薩斯
马克西姆=馬克沁
满坑满谷=滿坑滿谷
漫游生物=漫游生物
毛里求斯=模里西斯
茅山后裔=茅山後裔
孟加拉国=孟加拉
蒙头转向=矇頭轉向
梦游先生=夢游先生
密苏里州=密蘇里州
面向对象=物件導向
摩尔多瓦=莫爾達瓦
模范马路=模範馬路
墨迹未干=墨蹟未乾
模拟电路=類比電路
模拟电子=類比電子
模拟软件=類比軟體
模拟信号=類比信號
默认网关=預設閘道器
墨索里尼=墨索里尼
难割难舍=難割難捨
南京信息=南京資訊
难舍难分=難捨難分
尼日利亚=奈及利亞
年复一年=年復一年
怒发冲冠=怒髮衝冠
怒气冲天=怒氣衝天
帕特里克=派翠克
旁征博引=旁徵博引
泡沫塑料=泡沫塑料
抛头露面=抛頭露面
抛砖引玉=抛磚引玉
配置文件=設定檔
劈里啪啦=劈里啪啦
披头散发=披頭散髮
片言只语=片言隻語
屏幕保护=螢幕保護裝置
乒乓球台=乒乓球台
破口大骂=破口大駡
朴茨茅斯=朴茨茅斯
铺盖卷儿=鋪蓋捲兒
气冲牛斗=氣沖牛斗
气冲霄汉=氣衝霄漢
其他信息=其他資訊
签订协议=簽訂協定
前紧后松=前緊後鬆
千钧一发=千鈞一髮
前仆后继=前仆後繼
锲而不舍=鍥而不捨
亲水平台=親水準台
青出于蓝=青出於藍
情有独钟=情有獨鍾
穷追不舍=窮追不捨
鹊巢鸠占=鵲巢鳩佔
人工智能=人工智慧
人机界面=人機界面
人民警察=人民警察
人寿年丰=人夀年豐
人云亦云=人云亦云
日程安排=排程
日复一日=日復一日
乳臭未干=乳臭未乾
软件开发=軟體發展
撒啊啊啊=撒啊啊啊
萨格勒布=札格雷布
撒马尔罕=撒馬爾罕
塞拉利昂=獅子山
塞万提斯=賽凡提斯
散兵游勇=散兵游勇
桑给巴尔=桑吉巴
商品信息=商品資訊
舍本逐末=捨本逐末
舍己救人=捨己救人
舍己为公=捨己為公
舍己为人=捨己為人
设计文件=設計檔
舍近求远=捨近求遠
舍生取义=捨生取義
舍生忘死=捨生忘死
舍死忘生=捨死忘生
神谷浩史=神谷浩史
什么文件=什麼檔
圣彼得堡=聖彼德堡
生长发育=生長發育
圣地亚哥=聖地牙哥
圣马力诺=聖馬利諾
生物信息=生物資訊
市场信息=市場訊息
失而复得=失而復得
施工项目=施工專案
始建于唐=始建于唐
时紧时松=時緊時鬆
十六进制=十六進位
视频会议=視訊會議
尸位素餐=尸位素餐
事务处理=交易處理
首当其冲=首當其衝
收到信息=收到資訊
收费项目=收費專案
数据备份=資料備份
数据仓库=資料倉庫
数据传输=資料傳輸
数据存储=資料存儲
数据分析=資料分析
数据管理=資料管理
数据恢复=資料恢復
数据结构=資料結構
数据来源=資料來源
数据类型=資料類型
数据录入=資料錄入
数据模型=資料模型
数据收集=資料收集
数据统计=資料統計
数据通信=資料通信
数据网络=資料網路
数据文件=資料檔案
数据业务=資料業務
数据整理=資料整理
数据质量=資料品質
数据字典=資料字典
输入数据=輸入資料
数字电路=數位電路
数字控制=數位控制
数字密码=數位密碼
数字时钟=數位時鐘
数字通信=數位通信
数字图像=數位圖像
数字信号=數位信號
死而复生=死而復生
死灰复燃=死灰復燃
斯里兰卡=斯里蘭卡
四舍五入=四捨五入
斯威士兰=史瓦濟蘭
松松垮垮=鬆鬆垮垮
松松散散=鬆鬆散散
松赞干布=松贊干布
搜索引擎=搜尋引擎
苏宁易购=蘇甯易購
苏宁云商=蘇甯雲商
太聪明了=太聰明了
弹出窗口=快顯視窗
贪官污吏=貪官污吏
叹观止矣=嘆觀止矣
坦桑尼亚=坦尚尼亞
坛坛罐罐=罎罎罐罐
提供数据=提供資料
提示信息=提示資訊
天干物燥=天乾物燥
亭台楼阁=亭臺樓閣
统计数据=統計資料
统计信息=統計資訊
同流合污=同流合污
通天干探=通天幹探
通讯地址=通訊位址
偷梁换柱=偷樑換柱
图书信息=圖書資訊
图像处理=影像處理
唾面自干=唾面自乾
外强中干=外強中乾
万方数据=萬方資料
玩忽职守=怠忽職守
网络信息=網路資訊
望洋兴叹=望洋興嘆
未卜先知=未卜先知
危地马拉=瓜地馬拉
未可厚非=無可厚非
未能免俗=不能免俗
位置信息=位置資訊
文本文件=文字檔
文件格式=檔案格式
文件加密=檔加密
文件精神=檔精神
文件类型=檔案類型
文件系统=檔案系統
文字处理=文字處理
瓮中之鳖=甕中之鼈
瓮中捉鳖=甕中捉鼈
我的文档=我的文件
卧薪尝胆=臥薪嚐膽
乌得勒支=烏德勒支
物理内存=實體記憶體
五年计划=五年計劃
污水处理=汙水處理
乌苏里江=烏蘇里江
舞台灯光=舞臺燈光
无线数据=無線資料
无线通信=無線通訊
污言秽语=污言穢語
无以复加=無以復加
西北地区=西北地方
细嚼慢咽=細嚼慢嚥
系统配置=系統組態
系统信息=系統資訊
西游战记=西游戰記
西岳华山=西嶽華山
下拉菜单=下拉式功能表
下里巴人=下里巴人
下面一点=下面一點
下载文件=下載檔案
咸蛋超人=咸蛋超人
咸嘉新村=咸嘉新村
限位开关=限位元開關
闲言碎语=閒言碎語
闲言闲语=閒言閒語
咸与维新=咸與維新
相关数据=相關資料
相关文件=相關檔
项目编码=專案編碼
项目管理=專案管理
项目进度=專案進度
项目经理=專案經理
项目申报=專案申報
项目现场=專案現場
项目验收=專案驗收
项目资金=專案資金
相生相克=相生相剋
详细信息=詳細資訊
销售信息=銷售資訊
销售支持=銷售支援
歇斯底里=歇斯底里
协议存款=協定存款
辛丑条约=辛丑合約
心广体胖=心寬體胖
心理发展=心理發展
信息安全=資訊安全
信息采集=資訊採集
信息产业=資訊產業
信息处理=資訊處理
信息传递=資訊傳遞
信息大厦=資訊大廈
信息发布=資訊發佈
信息发送=資訊發送
信息反馈=資訊回饋
信息服务=資訊服務
信息工程=資訊工程
信息公开=資訊公開
信息共享=資訊共用
信息管理=資訊管理
信息技术=資訊技術
信息检索=資訊檢索
信息交流=資訊交流
信息科技=資訊科技
信息科学=資訊科學
信息披露=資訊披露
信息平台=資訊平臺
信息时报=資訊時報
信息时代=資訊時代
信息收集=資訊收集
信息统计=資訊統計
信息网络=資訊網路
信息系统=資訊系統
信息中心=資訊中心
信息咨询=資訊諮詢
信息资源=資訊資源
形单影只=形單影隻
星罗棋布=星羅棋佈
星移斗转=星移斗轉
形影相吊=形影相弔
凶神恶煞=兇神惡煞
凶相毕露=兇相畢露
虚怀若谷=虛懷若谷
虚假信息=虛假資訊
虚拟现实=虛擬實境
旭日东升=旭日東昇
血浓于水=血濃於水
学生信息=學生資訊
学习文件=學習檔
学习用品=學習用品
循环往复=循環往復
循环系统=循環系統
亚历山大=亞歷山大
压缩文件=壓縮檔
研究对象=研究物件
烟熏火燎=煙薰火燎
羊肠小道=羊腸小徑
阳谷华泰=陽谷華泰
仰韶文化=仰紹文化
也说明了=也說明了
液位开关=液位元開關
移动电话=行動電話
一发千钧=一髮千鈞
一干二净=一乾二淨
一个文件=一個檔
倚老卖老=以老賣老
伊利诺伊=伊利諾
伊丽莎白=伊莉莎白
医学信息=醫學資訊
依依不舍=依依不捨
异于常人=異于常人
伊于胡底=伊于胡底
一只眼睛=一隻眼睛
抑制作用=抑制作用
印第安纳=印第安那
吟游诗人=吟游詩人
阴云密布=烏雲密佈
映像文件=映射檔
用户界面=使用者介面
用户密码=使用者密碼
游必有方=游必有方
游标卡尺=遊標卡尺
幼儿教育=幼稚教育
游枷利叶=游枷利葉
有鉴于此=有鑑於此
游就游吧=游就遊吧
游来游去=游來遊去
游目四顾=游目四顧
游手好闲=遊手好閒
游闲公子=游閑公子
有效信息=有效資訊
游游荡荡=遊遊蕩蕩
悠游自在=悠游自在
邮政编码=郵遞區號
于国于民=于國於民
寓教于乐=寓教於樂
寓情于景=寓情于景
于情于理=于情於理
玉汝于成=玉汝于成
御史大夫=御史大夫
余氏东风=余氏東風
于斯为盛=于斯為盛
于意云何=于意雲何
余荫山房=余蔭山房
语音识别=語音辨識
余勇可贾=余勇可賈
鱼游釜中=魚游釜中
宇宙飞船=太空船
远程教育=遠端教育
远程控制=遠程控制
远程连接=遠端連接
原始数据=原始資料
岳麓大道=岳麓大道
运行时间=執行時間
赞不绝口=讚不絕口
扎扎实实=扎扎實實
债台高筑=債臺高築
张灯结彩=張燈結綵
掌上电脑=掌上型電腦
招标项目=招標專案
招聘信息=招聘資訊
这是地址=這是位址
政府信息=政府資訊
政务信息=政務資訊
指鸡骂狗=指雞駡狗
直角坐标=直角坐標
质量管理=品質管制
智能电视=智慧電視
智能控制=智慧控制
智能武器=智慧型武器
智能硬件=智慧硬體
智能制造=智慧製造
指桑骂槐=指桑駡槐
知识产权=智慧財產權
只手遮天=隻手遮天
只言片语=隻言片語
止于智者=止于智者
秩秩斯干=秩秩斯干
重大项目=重大專案
周而复始=周而復始
注册商标=注冊商標
准备考研=准備考研
擢发难数=擢髮難數
子丑寅卯=子丑寅卯
自动应答=自動回應
资源分配=資源配置
租赁协议=租賃協定
最新地址=最新位址
巴埃灯鳉=﻿巴埃燈鱂
巴塞洛缪=巴薩羅繆
百谷之王=百谷之王
柏宁大厦=柏甯大廈
白日作梦=做白日夢
白岳黄芽=白岳黃芽
百只足夠=百隻足夠
班伯里联=班伯里聯
板谷由夏=板谷由夏
伴游小姐=伴游小姐
邦宁沙吉=邦甯沙吉
爆发指数=爆發指數
保罗索萨=保羅梭薩
保密信息=保密資訊
保宁半夏=保甯半夏
包销协议=包銷協定
贝尔莫潘=貝爾墨邦
贝齐米特=貝琪米特
北周六典=北周六典
比亚里茨=比亞里茨
必作于易=必作于易
变更项目=變更專案
编码数据=編碼資料
编译程序=編譯器
变质量系=變質量系
表面点火=表面點火
表面条件=表面條件
表现对象=表現物件
标准文件=標準檔
别范安成=別范安成
并联系统=並聯系統
并行操作=平行作業
并行端口=平行埠
并行数据=並行資料
并行算法=平行算法
病于夏畦=病于夏畦
波多诺伏=波多洛
剥极必复=剝極必復
卜家庄乡=卜家莊鄉
博士多宁=博士多甯
波斯尼亚=波士尼亞
卜夜卜昼=卜夜蔔晝
布尔格斯=布爾格斯
布尔函数=布耳函數
部分进位=部分進位元
不拘于时=不拘于時
布拉干萨=布拉干薩
布雷斯特=布列斯特
布里奇顿=橋鎮
补炉料斗=補爐料鬥
不伦瑞克=布勞恩斯魏克
不止于万=不止于萬
卜昼卜夜=卜晝蔔夜
被发缨冠=被髮纓冠
被发左衽=被髮左衽
采风问俗=採風問俗
菜品质量=菜品質量
彩屏干版=彩屏乾版
彩秀美发=彩秀美發
苍黄翻复=蒼黃翻覆
测试响应=測試響應
层峦迭嶂=層巒疊嶂
查尔斯顿=查爾斯頓
叉管制作=叉管制作
昌发油脂=昌發油脂
长谷川步=長谷川步
长元音符=長元音符
朝崎郁惠=朝崎郁惠
成像素质=成像素質
赤绳系足=赤繩繫足
崇岳禅师=崇岳禪師
抽样数据=抽樣資料
出谷黄莺=出谷黃鶯
出谷迁乔=出谷遷喬
初始对象=初始物件
出于林中=出於林中
串联系统=串聯系統
传输信息=傳輸資訊
串行传输=序列傳輸
串行鼠标=序列滑鼠
窗口函数=視窗函數
窗口作用=視窗作用
创作空间=﻿創作空間
磁性固位=磁性固位元
词语信息=詞語資訊
脆皮面包=脆皮面包
存储元件=記憶元件
存亡未卜=存亡未卜
错误数据=錯誤資料
大谷大学=大谷大學
大谷美纪=大谷美紀
大谷石佛=大谷石佛
大谷太郎=大谷太郎
大面市场=大面市場
打漂游儿=打漂游兒
大曲菌素=大麴菌素
贷款协议=貸款協定
代理发行=代理發行
单步操作=單步作業
单选按钮=選項按鈕
丹郁骨康=丹郁骨康
档案文件=檔案檔
党坚势盛=党堅勢盛
党留庄乡=党留莊鄉
当前目录=目前的目錄
等待状态=等候狀態
低级语言=低階語言
地址空间=位址空間
地址映射=位址映射
地址总线=位址匯流排
电报数据=電報資料
点只功夫=點隻功夫
跌荡不羁=跌盪不羈
跌荡不拘=跌盪不拘
跌荡风流=跌盪風流
丁宁深意=丁甯深意
东慕谷韩=東慕谷韓
东宁卫乡=東甯衛鄉
动态绑定=動態繫結
东游丛录=東游叢錄
斗转参横=斗轉參橫
独挡一面=獨當一面
独立户口=獨立戶口
笃于时也=篤于時也
断发文身=斷髮文身
对象连接=物件連接
对象语言=物件語言
敦刻尔克=敦克爾克
多边协议=多邊協定
多道程序=多道程序
多余信息=多餘資訊
调试程序=偵錯工具
而百姓宁=而百姓甯
二谷理惠=二谷理惠
二进制位=二進位位元
发明信息=發明資訊
发卡银行=發卡銀行
法师处咸=法師處咸
法师仁岳=法師仁岳
法师咸润=法師咸潤
法师与咸=法師與咸
伐树于宋=伐樹于宋
范埃伊登=范埃伊登
范布克林=范布克林
范德古恩=范德古恩
范德梅德=范德梅德
范德沙夫=范德沙夫
范德夏夫=范德夏夫
范登博雷=范登博雷
范登伊德=范登伊德
范丁特尔=范丁特爾
范费塞姆=范費塞姆
翻复无常=翻覆無常
范哥特姆=范哥特姆
范海弗滕=范海弗滕
泛黄发花=泛黃發花
范霍维伦=范霍維倫
范家庄乡=范家莊鄉
范米尔洛=范米爾洛
范穆里克=范穆裡克
反舍于鲁=反舍于魯
范田纱纱=范田紗紗
范徐丽泰=范徐麗泰
反于帝宫=反于帝宮
范张鸡黍=范張雞黍
访问控制=存取控制
费用信息=費用資訊
非尊于齐=非尊于齊
分发指令=分發指令
分类项目=分類專案
酚醛塑料=酚醛塑料
分组密码=區塊編碼器
凤巢七层=﻿鳳巢七層
丰宁管业=豐甯管業
丰宁原始=豐寧原始
丰台北路=豐台北路
符号文件=符號檔
附加协议=附加協定
附加载荷=附加載荷
弗里波特=弗里波特
父母于子=父母于子
富纳富提=福納佛提
福宁大厦=福甯大廈
福塔莱萨=福塔雷薩
附图标记=附圖標記
服务协议=服務協定
改进项目=改進專案
陔余丛考=陔余叢考
干巴利脆=乾巴利脆
感光干版=感光乾版
干卿底事=干卿底事
干云蔽日=乾雲蔽日
高档商品=高級商品
高速缓存=快取記憶體
各个组件=各個元件
个股分析=個股分析
葛谷叶子=葛谷葉子
格雷戈里=葛列格里
根据协议=根據協定
工程控制=工程控制
拱桥台身=拱橋台身
工艺程序=工藝程序
工作队列=工作隊列
工作数据=工作資料
谷川理沙=谷川理沙
谷达坡乡=谷達坡鄉
谷父蚕母=谷父蠶母
谷宫悌二=谷宮悌二
谷宫绚子=谷宮絢子
古谷芳香=古谷芳香
古谷沙织=古谷沙織
谷家营村=谷家營村
谷金楼乡=谷金樓鄉
谷糠太林=谷糠太林
谷口麻美=谷口麻美
谷罗山乡=谷羅山鄉
谷马砺兵=谷馬礪兵
谷美靓汤=谷美靚湯
沽名干誉=沽名干譽
股票信息=股票資訊
谷山纪章=谷山紀章
谷神同道=谷神同道
谷盛农资=谷盛農資
谷宋巨子=谷宋鉅子
谷穗黄了=谷穗黃了
谷威米业=谷威米業
谷围新村=谷圍新村
谷秀年丰=谷秀年豐
古岳宗亘=古岳宗亙
故障模拟=故障類比
瓜达卢佩=瓜達羅佩
关系演算=關聯計算法
归档文件=歸檔檔
鬼谷道士=鬼谷道士
过程数据=過程資料
过于平稳=過於平穩
果于自信=果于自信
海岳大厦=海岳大廈
海岳名言=海岳名言
韩佳宁韩=韓佳甯韓
函数调用=函式呼叫
黑谷友香=黑谷友香
宏发化工=巨集發化工
洪范池镇=洪范池鎮
洪炉燎发=洪爐燎髮
红绳系足=紅繩繫足
洪岳宗演=洪岳宗演
侯服于周=侯服于周
厚朴温中=厚朴溫中
后台任务=幕後工作
侯于周服=侯于周服
互操作性=互通性
胡涂福星=糊塗福星
胡涂太太=糊塗太太
互相干擾=互相幹擾
画栋雕梁=畫棟雕樑
华东木蓝=﻿華東木藍
画舫余谭=畫舫余譚
华联机械=華聯機械
华宁肥牛=華甯肥牛
怀宁贡糕=懷甯貢糕
环境信息=環境資訊
还朴反古=還朴反古
黄梁美梦=黃樑美夢
灰谷巨熊=灰谷巨熊
灰谷森林=灰谷森林
混联系统=混聯系統
吉非贝齐=吉非貝琪
机密信息=機密資訊
济宁枫林=濟甯楓林
济宁市任=濟甯市任
机器智能=機器智慧
技术信息=技術資訊
基思奥马=基斯奧馬
计算智能=計算智慧
机位定点=機位元定點
价格信息=價格資訊
加利波里=加利波里
佳宁娜毛=佳甯娜毛
鉴别信息=鑒別資訊
监控程序=監控程序
建宁金腰=建甯金腰
兼容机箱=兼容機箱
碱土金属=鹼土金屬
建议文件=建議檔
姜各庄镇=姜各莊鎮
姜格庄镇=姜格莊鎮
姜桂之性=姜桂之性
姜记龙虾=薑記龍蝦
姜家营乡=姜家營鄉
姜氏饼王=姜氏餅王
姜汁赤贝=姜汁赤貝
矫情干誉=矯情干譽
教师信息=教師資訊
教头发威=教頭發威
较小区域=較小區域
杰拉尔德=吉羅德
杰内斯特=傑内斯特
解郁肝舒=解郁肝舒
金谷大厦=金谷大廈
金谷俊游=金谷俊遊
金谷园黄=金谷園黃
进浑仪表=進渾儀表
金子莉萨=金子麗莎
静电屏蔽=靜電屏蔽
景谷东路=景谷東路
景谷中路=景谷中路
景山后街=景山後街
经验对象=經驗物件
救姜刑警=救姜刑警
卷吸作用=捲吸作用
决策信息=決策資訊
竣工场地=竣工場地
开郁舒肝=開郁舒肝
考虑平衡=﻿考慮平衡
客户协议=客戶協定
克里特岛=克里特島
空谷白驹=空谷白駒
空谷明应=空谷明應
口头协议=口頭協定
口燥唇干=口燥脣乾
况余白首=況余白首
乐可可巧=樂可可巧
泪干肠断=淚乾腸斷
历史信息=歷史資訊
李郁庄乡=李郁莊鄉
燎发摧枯=燎髮摧枯
流于平庸=流於平庸
龙谷大学=龍谷大學
龙谷修武=龍谷修武
龙游农家=龍遊農家
龙游曲沼=龍游曲沼
逻辑模拟=邏輯類比
逻辑移位=邏輯移位元
罗马里奇=羅馬裡奇
落日余辉=落日餘暉
绿谷渔阳=綠谷漁陽
玛宁青楚=瑪甯青楚
满谷满坑=滿谷滿坑
尨眉皓发=尨眉皓髮
没精打彩=無精打采
梦游天国=夢游天國
免于刑戮=免于刑戮
苗乡谷农=苗鄉谷農
民谷菌苑=民谷菌苑
名波里南=名波里南
明窗净几=明窗淨几
鸣于乔木=鳴于喬木
模范西路=模範西路
模糊数据=模糊資料
模拟程序=類比程式
模拟视频=類比視頻
模拟系统=類比系統
模拟语言=類比語言
目标语言=目的語言
穆尔西亚=穆爾西亞
木腐菌类=﻿木腐菌類
木谷麻耶=木谷麻耶
内基因子=內基因子
内幕信息=內幕資訊
能人于四=能人于四
辇来于秦=輦來于秦
年于柏林=年于柏林
宁巴灯鳉=甯巴燈鱂
宁陈炭业=甯陳炭業
宁城北路=甯城北路
宁城南路=甯城南路
宁城中路=甯城中路
宁川东路=甯川東路
宁川西路=甯川西路
宁东北路=甯東北路
宁都三魏=甯都三魏
宁墩西路=甯墩西路
宁墩中路=甯墩中路
宁海东路=甯海東路
宁海太平=甯海太平
宁海西路=甯海西路
宁海中学=甯海中學
宁记麻辣=寧記麻辣
宁马高速=甯馬高速
宁贸大厦=甯貿大廈
宁宁金碳=甯甯金碳
宁水花园=甯水花園
宁条梁镇=甯條梁鎮
宁心益智=甯心益智
宁夜安梦=甯夜安夢
宁油麻藤=甯油麻藤
宁于祸福=甯於禍福
牛黄宁宫=牛黃甯宮
曝光标度=曝光標度
帕克斯顿=帕克斯頓
帕斯科里=帕斯科裡
拍摄信息=拍攝資訊
盘谷禅师=盤谷禪師
旁联系统=旁聯系統
庞眉皓发=龐眉皓髮
频带宽度=頻帶寬度
平面点集=平面點集
平面线形=平面線形
屏幕菜单=螢幕功能表
朴沉化郁=朴沉化鬱
朴者和尚=朴者和尚
千只足夠=千隻足夠
强制冷却=強制冷卻
清姜见龙=清姜見龍
青天霹雳=晴天霹靂
染谷龙将=染谷龍將
人工模拟=人工類比
日历年度=日曆年度
荣发胶囊=榮發膠囊
融情于景=融情于景
入于权家=入于權家
三面包围=三面包圍
三位编码=三位元編碼
桑谷夏子=桑谷夏子
山鸣谷应=山鳴谷應
商场信息=商場資訊
上方宝剑=尚方寶劍
上游街道=上游街道
少年枪党=少年槍党
少年游侠=少年遊俠
少年岳飞=少年岳飛
射程控制=射程控制
涉谷武尊=涉谷武尊
涉谷辛弘=涉谷辛弘
涉谷有利=涉谷有利
摄影信息=攝影資訊
神谷沙织=神谷沙織
深蓝的海=﻿深藍的海
甚于水火=甚於水火
生理发生=生理發生
圣托马斯=聖托馬斯
剩余成本=剩餘成本
剩余强度=剩餘強度
辻谷耕史=辻谷耕史
视觉信息=視覺資訊
诗宁大厦=詩甯大廈
视听信息=視聽資訊
实验数据=實驗資料
使于四方=使于四方
始于玄冥=始于玄冥
受理窗口=受理視窗
受理文件=受理檔
受械于陈=受械于陳
狩岳巡方=狩岳巡方
数据参数=資料參數
数据测试=資料測試
数据差错=資料差錯
数据冲突=資料衝突
数据丢失=資料丟失
数据分布=資料分佈
数据环境=資料環境
数据获取=資料獲取
数据精度=資料精度
数据驱动=資料驅動
数据手套=資料手套
数据通道=資料通道
数据总线=資料匯流排
数值数据=數值資料
数字技术=數位技術
数字影像=數位影像
双位编码=雙位元編碼
水谷麻理=水谷麻理
水谷麻子=水谷麻子
水平方式=水準方式
水平方向=水準方向
税收文件=稅收檔
瞬时速度=瞬時速度
顺序处理=連續處理
说岳全传=說岳全傳
四谷怪谈=四谷怪談
四面包围=四面包圍
松驰路径=鬆馳路徑
松驰预算=鬆馳預算
松谷英子=松谷英子
搜集信息=搜集資訊
苏宁银河=蘇甯銀河
台上台下=臺上台下
特定对象=特定物件
藤谷美纪=藤谷美紀
题于石上=題于石上
铁路桥梁=鐵路橋梁
桐谷修二=桐谷修二
同游张园=同游張園
吐哺握发=吐哺握髮
图片窗口=圖片視窗
图片信息=圖片資訊
图像信息=圖像資訊
拓谷牛排=拓穀牛排
瓦科拉夫=瓦科拉夫
外汇报价=外匯報價
外基因子=外基因子
外婆桥宁=外婆橋甯
外师造化=﻿外師造化
万宁大厦=萬甯大廈
万岳朝宗=萬岳朝宗
网游洪荒=網游洪荒
网游金庸=網游金庸
网游魔童=網游魔童
危辞耸听=危言聳聽
威士忌酒=威士忌酒
微型组件=微型元件
文采花园=文采花園
问谷奚事=問谷奚事
文件安全=檔安全
文件传送=檔傳送
文件定义=檔定義
文件分段=檔分段
文件共享=檔共用
文件规约=檔規約
文件空间=檔空間
文件条文=檔條文
文件维护=檔維護
闻名遐尔=聞名遐邇
握发吐哺=握髮吐哺
握发吐飧=握髮吐飧
无偿协议=無償協定
屋脊梁木=屋脊梁木
物理模拟=物理類比
武宁新村=武甯新村
污七八糟=污七八糟
吾妻归宁=吾妻歸甯
物位开关=物位元開關
无用信息=無用資訊
乌游王蛇=烏游王蛇
行于大道=行于大道
西卜沙乡=西卜沙鄉
系风捕影=繫風捕影
细节信息=細節資訊
西奎埃拉=西奎艾拉
西里西亚=西里西亞
系统模拟=系統類比
吸血脉冲=吸血脈沖
下不了台=下不了臺
现代舞台=現代舞台
咸淡江湖=鹹淡江湖
咸丘蒙曰=咸丘蒙曰
限位装置=限位元裝置
咸享和平=咸享和平
现有菜单=現有功能表
仙游岛韩=仙游島韓
项目评价=專案評價
项目收尾=專案收尾
祥游沙麓=祥游沙麓
销售数字=銷售數位
邪不干正=邪不干正
协议失败=協定失敗
信息爆炸=資訊爆炸
信息编码=資訊編碼
信息成本=資訊成本
信息储存=資訊儲存
信息传播=資訊傳播
信息传输=資訊傳輸
信息分类=資訊分類
信息格式=資訊格式
信息估计=資訊估計
信息函数=資訊函數
信息加工=資訊加工
信息交换=資訊交換
信息结构=資訊結構
信息客体=資訊客體
信息空间=資訊空間
信息模型=資訊模型
信息内容=資訊內容
信息社会=資訊社會
信息提取=資訊提取
信息细节=資訊細節
信息显示=資訊顯示
信息效益=資訊效益
信息因素=資訊因素
信息职业=資訊職業
信息主管=資訊主管
信息主体=資訊主體
信息字段=資訊欄位
星艾丽斯=星愛麗絲
星火计划=星火計劃
熊谷尚武=熊谷尚武
熊谷英理=熊谷英理
序列信息=序列資訊
雪宁韦伯=雪寧韋伯
雪松手杖=雪松手杖
雪岳山韩=雪岳山韓
循环小数=循環小數
亚邦利尔=﻿亞邦利爾
岩谷云游=岩谷雲遊
瑶台山庄=瑤台山莊
一个对象=一個物件
以太位面=乙太位元面
移位指令=移位元指令
阴影位面=陰影位元面
尹余小学=尹余小學
应付项目=應付專案
硬面包片=硬面包片
映射地址=映射位址
影像素质=影像素質
用户标识=使用者標識
用户日志=使用者日誌
永宁禅师=永甯禪師
永宁东路=永甯東路
永宁西关=永甯西關
永宁中学=永甯中學
游遍芳丛=游遍芳叢
游不沾水=游不沾水
游法华寺=游法華寺
游凤戏龙=游鳳戲龍
游宦纪闻=游宦紀聞
游黄檗山=游黃檗山
游回大海=游回大海
游井亮子=游井亮子
游居士录=游居士錄
游梁琐记=游梁瑣記
游梁新集=游梁新集
游平鳍鮠=游平鰭鮠
游鳍叶鲹=游鰭葉鯵
游山逛水=游山逛水
游石门涧=游石門澗
游太平山=游太平山
游仙游山=游仙遊山
游向高棉=游向高棉
尤杨范陆=尤楊范陸
有余庄村=有餘莊村
游云惊龙=游雲驚龍
游云居寺=游雲居寺
于安思危=于安思危
余杯冷炙=余杯冷炙
于頔居士=于頔居士
于府肥牛=于府肥牛
于府榆林=于府榆林
郁伽长者=郁伽長者
于家房镇=于家房鎮
于家水饺=於家水餃
余麦口咽=余麥口咽
裕宁潮王=裕甯潮王
裕宁二楼=裕甯二樓
于潜七兄=于潛七兄
于汝安乎=于汝安乎
余膳郁子=余膳鬱子
余尚童稚=余尚童稚
雨水平箅=雨水平箅
于汤有光=于湯有光
语言信息=語言資訊
语义信息=語義資訊
鱼游春水=魚游春水
余仲宗琇=余仲宗琇
远程查询=遠端查詢
远程导弹=遠端導彈
远程服务=遠端服務
远程会议=遠端會議
远程教学=遠端教學
远程结构=遠端結構
远程武器=遠端武器
原始文件=原始檔
岳程街道=岳程街道
岳化社区=岳化社區
岳列天孙=岳列天孫
岳权道场=岳權道場
月神色拉=月神色拉
岳式连拳=岳式連拳
云谷禅师=雲谷禪師
重复线条=重複線條
粘膜支持=粘膜支援
在谷满谷=在谷滿穀
载宁龙二=載甯龍二
泽默林环=澤梅林環
增谷康纪=增谷康紀
战场信息=戰場資訊
战役布势=戰役佈勢
张谷英镇=張谷英鎮
赵卜小学=趙卜小學
赵公元帅=趙公元帥
照片数据=照片資料
帧缓存器=幀暫存器
针体制作=針體制作
蒸发胶片=蒸發膠片
支持细胞=支援細胞
雉罹于罗=雉罹于羅
治疗能力=﻿治療能力
智能仪表=智慧型儀器表
智能主体=智慧主體
终端用户=終端使用者
中谷鞍罗=中谷鞍羅
中谷美纪=中谷美紀
中文信息=中文資訊
昼尔于茅=晝爾于茅
子插件板=子插件板
仔姜辣米=仔姜辣米
子畏于匡=子畏于匡
子于宋者=子于宋者
醉游平泉=醉游平泉
作图标记=作圖標記
左右采获=左右採獲
作战对象=作戰物件
八月湖水平=八月湖水平
半夏厚朴汤=半夏厚朴湯
布尔什维克=布爾什維克
春天后母心=春天後母心
但余钟磬音=但余鐘磬音
厄立特里亚=厄立特里亞
防范于未然=防範于未然
规范性文件=規範性檔
教育信息化=教育資訊化
君子喻于义=君子喻于義
克里姆林宫=克里姆林宮
雷克雅未克=雷克雅維克
里约热内卢=里約熱內盧
毛里塔尼亚=茅利塔尼亞
诺曼底登陆=諾曼地登陸
沙特阿拉伯=沙烏地阿拉伯
十足女神范=十足女神范
数字后切换=數位後切換
斯大林格勒=斯大林格勒
万户捣衣声=萬戶擣衣聲
文件管理器=檔案管理員
文件浏览器=檔流覽器
相忘于江湖=相忘於江湖
信息化建设=資訊化建設
刑天舞干戚=刑天舞干戚
兄弟阋于墙=兄弟鬩于牆
亚得里亚海=亞得里亞海
伊斯坦布尔=伊斯坦布爾
云南信息港=雲南資訊港
淄博信息港=淄博資訊港
巴利米纳联=巴利米納聯
罢去游说客=罷去游說客
百谷漏波涛=百谷漏波濤
白花飞历乱=白花飛歷亂
白面具藏戏=白面具藏戲
暴发型霍乱=暴發型霍亂
暴发型痢疾=暴發型痢疾
保宁玑禅师=保甯璣禪師
薄游何所愧=薄游何所愧
被防护对象=被防護物件
悲生万里外=悲生萬裡外
北游君似智=北游君似智
奔走于四方=奔走于四方
毕生发展观=畢生發展觀
彼于女何有=彼于女何有
表信息分子=表資訊分子
别君良郁陶=別君良郁陶
宾游马佩衡=賓游馬佩衡
伯党回族乡=伯党回族鄉
卜邻南山幽=卜鄰南山幽
卜邻应见容=卜鄰應見容
伯鸾游太学=伯鸞游太學
薄暮游大梁=薄暮游大樑
卜商读书帖=卜商讀書帖
伯氏朴丽鱼=伯氏朴麗魚
卜田向何许=卜田向何許
卜葬于故墓=卜葬於故墓
卜征从献吉=卜征從獻吉
卜筑汉江边=卜築漢江邊
步兵战斗车=步兵戰鬥車
不翅于父母=不翅于父母
不减旧游时=不減舊游時
布里斯托尔=布里斯托爾
不能舍余习=不能舍余習
不任于圣人=不任于聖人
布氏青水虱=布氏青水蝨
卜算子咏梅=卜運算元詠梅
不完全信息=不完全資訊
不完整信息=不完整資訊
不夜天皇后=不夜天皇後
菜单选择式=功能表選擇式
采地包山河=埰地包山河
骖驭游青云=驂馭游青雲
長谷部史親=長谷部史親
长谷部史亲=長谷部史親
长谷川惠美=長谷川惠美
长谷川理惠=長谷川理惠
长谷川小夏=長谷川小夏
常恐游此方=常恐游此方
常随旅客游=常隨旅客游
朝集咸林城=朝集咸林城
朝游极斜景=朝游極斜景
朝游涟水傍=朝游漣水傍
朝游天苑外=朝游天苑外
朝游伊水湄=朝游伊水湄
朝游云汉省=朝游雲漢省
朝游云霄间=朝游雲霄間
尘飞金谷苑=塵飛金谷苑
宸游霁色高=宸游霽色高
宸游近甸荣=宸游近甸榮
宸游经上苑=宸游經上苑
宸游满路辉=宸游滿路輝
宸游若饮丰=宸游若飲豐
宸游转翠华=宸游轉翠華
澄彻天为底=澄澈天為底
耻从侠烈游=恥從俠烈游
愁心随斗柄=愁心隨斗柄
出谷此何迟=出谷此何遲
出谷莺初语=出谷鶯初語
串行输出制=串行輸出制
垂直于水面=垂直於水面
春随斗柄回=春隨斗柄回
此谷本来平=此谷本來平
此理余莫测=此理余莫測
词位结构学=詞位元結構學
葱白姜糖汤=蔥白姜糖湯
从今万里外=從今萬裡外
从余问古事=從余問古事
存财于信徒=存財于信徒
打草谷宋兵=打草谷宋兵
大谷奈津江=大谷奈津江
大谷羊太郎=大谷羊太郎
大战宁沪杭=大戰甯滬杭
带剑游淮阴=帶劍游淮陰
带信息分子=帶資訊分子
代业京华里=代業京華裡
待余逢石髓=待余逢石髓
丹谷耀华桑=丹谷耀華桑
丹尼艾丽斯=丹尼愛麗絲
单字节校正=單字節校正
导航天灾石=導航天災石
道心宁易处=道心甯易處
道隐于小成=道隱于小成
德至同于初=德至同于初
登于白玉盘=登于白玉盤
第七只色狼=第七只色狼
地下游击队=地下遊擊隊
电视台风云=電視臺風雲
调度信息池=調度資訊池
顶著台风雨=頂著台風雨
东道昼游初=東道晝游初
东归余谢病=東歸余謝病
斗柄乘时转=斗柄乘時轉
斗柄更初转=斗柄更初轉
斗柄临高城=斗柄臨高城
斗柄欲东指=斗柄欲東指
髑髅有余乐=髑髏有餘樂
独游爱方塘=獨游愛方塘
独游景常晏=獨游景常晏
独游念求仲=獨游念求仲
独游岂易惬=獨游豈易愜
独游情易阑=獨游情易闌
独游隋苑东=獨游隋苑東
对象式方法=物件式方法
多媒体文件=多媒體檔
多少游春意=多少游春意
多元音位学=多元音位學
调试程序包=偵錯工具包
二谷友理惠=二谷友理惠
二景郁生光=二景郁生光
范阿尔绍特=范阿爾紹特
范艾二氏病=范艾二氏病
范安霍尔特=范安霍爾特
范伯子诗集=范伯子詩集
范登奥维兰=范登奧維蘭
范登布罗克=范登布羅克
翻复饯征客=翻覆餞征客
范弗拉罗迪=范弗拉羅迪
范高雷中尉=范高雷中尉
范霍伊维恩=范霍伊威恩
范吉塞埃姆=范吉塞埃姆
范家卓子乡=范家卓子鄉
范凯克霍温=范凱克霍溫
范柯二氏法=范柯二氏法
范麦二氏法=范麥二氏法
范妮罗斯比=范妮羅斯比
范欧登霍温=范歐登霍溫
范氏副叶鲹=范氏副葉鯵
范氏平鳍鳅=范氏平鰭鰍
范氏朴丽鱼=范氏樸麗魚
藩守宁为重=藩守甯為重
范叔寒犹在=范叔寒猶在
范叔已归秦=范叔已歸秦
范斯丁博格=范斯丁柏格
范托恩胡特=范托恩胡特
范沃森医生=范沃森醫生
范晔顾其儿=范曄顧其兒
范云堪晚友=范雲堪晚友
范子平胡同=范子平胡同
防祸于未然=防禍于未然
房山岳各庄=房山嶽各莊
非专利文件=非專利檔
丰富的信息=豐富的資訊
风归花历乱=風歸花歷亂
扶榇归咸秦=扶櫬歸咸秦
夫子与之游=夫子與之游
干羽方怀远=干羽方懷遠
干云松作盖=干雲松作蓋
高程控制点=高程控制點
高程控制网=高程控制網
高祖郁龙骧=高祖郁龍驤
格勒诺布尔=格勒諾布爾
根谷美智子=根谷美智子
更传千里外=更傳千裡外
公布的数据=公佈的資料
公子过我游=公子過我游
谷北草全稀=谷北草全稀
谷丙甘氨酸=谷丙甘氨酸
顾恩宁顾终=顧恩甯顧終
固而近于费=固而近于費
孤帆万里外=孤帆萬裡外
谷根小苏息=谷根小蘇息
谷广水涣涣=谷廣水渙渙
谷黄色硬皮=谷黃色硬皮
谷口何人待=谷口何人待
谷口疏钟动=谷口疏鐘動
谷口云迎马=谷口雲迎馬
谷粒燕翅鲍=谷粒燕翅鮑
谷鸟啭尚涩=谷鳥囀尚澀
故人游画阁=故人游畫閣
谷山崇禅师=谷山崇禪師
谷邃凉阴静=谷邃涼陰靜
故乡千里外=故鄉千裡外
谷映朱栏秀=谷映朱欄秀
孤游怀耿介=孤游懷耿介
顾于韩蔡内=顧于韓蔡內
孤舟万里外=孤舟萬裡外
挂帆游白水=掛帆遊白水
管蔡宁相容=管蔡甯相容
冠盖游梁日=冠蓋游梁日
光背团水虱=光背團水蝨
鬼谷还成道=鬼谷還成道
鬼谷四友志=鬼谷四友志
归途千里外=歸途千裡外
国赖姜任盛=國賴姜任盛
哈里斯堡人=哈里斯堡人
海谷移文省=海谷移文省
还游不死方=還游不死方
海岳三峰古=海岳三峰古
寒谷梅犹浅=寒谷梅猶淺
函谷青山外=函谷青山外
函谷壮皇居=函谷壯皇居
杭州咸件儿=杭州咸件兒
号燕谷老人=號燕谷老人
号于湖居士=號于湖居士
号至游居士=號至游居士
河岳出云雨=河岳出雲雨
河岳空金汤=河岳空金湯
河岳阴符启=河岳陰符啟
河岳英灵集=河岳英靈集
黑谷屯行军=黑谷屯行軍
衡岳泉禅师=衡岳泉禪師
鸿宝宁全秘=鴻寶甯全秘
鸿毛于泰山=鴻毛于泰山
后进于礼乐=後進于禮樂
扈跸游玄地=扈蹕游玄地
胡里山炮台=胡裡山炮台
花椒姜枣汤=花椒姜棗湯
化学信息的=化學資訊的
化学信息素=化學資訊素
华岳金天晶=華岳金天晶
怀禄宁期达=懷祿甯期達
怀哉余所陈=懷哉余所陳
宦游成楚老=宦游成楚老
宦游归无时=宦游歸無時
宦游今未迟=宦游今未遲
宦游久不乐=宦游久不樂
宦游偏不乐=宦游偏不樂
欢游续旧旬=歡游續舊旬
荒谷恩仇记=荒谷恩仇記
皇家卡西诺=皇家卡西諾
灰谷先驱者=灰谷先驅者
灰谷月亮井=灰谷月亮井
或问余所营=或問余所營
羁离忆友于=羈離憶友于
济宁肥羊王=濟甯肥羊王
济宁小吃苑=濟甯小吃苑
即色游玄论=即色游玄論
计算机模拟=電腦類比
嘉宾发菜馆=嘉賓發菜館
加尔范上尉=加爾范上尉
佳宁娜远洋=佳甯娜遠洋
加斯佩里尼=加斯佩裡尼
佳游满帝乡=佳游滿帝鄉
佳游亦屡展=佳游亦屢展
渐变管制作=漸變管制作
健儿宁斗死=健兒甯鬥死
菅谷初音乃=菅谷初音乃
涧谷芳菲少=澗谷芳菲少
建旟千里外=建旟千裡外
姜茶乌梅粥=姜茶烏梅粥
将从海岳居=將從海岳居
姜醋白切蟹=姜醋白切蟹
姜公干锅王=姜公幹鍋王
姜家桥新村=姜家橋新村
姜家营子乡=姜家營子鄉
将余去国泪=將余去國淚
姜斋诗文集=姜齋詩文集
接触摄影后=接觸攝影後
结交北游魏=結交北游魏
借问游天使=借問游天使
戒兹游衍乐=戒茲游衍樂
今从太子游=今從太子游
近谷藏飕飗=近谷藏颼飀
金谷盛招携=金谷盛招攜
金谷园中柳=金谷園中柳
金华里社区=金華裡社區
金马台山庄=金馬台山莊
进士苟非党=進士苟非党
敬时穷发敛=敬時窮髮斂
晶体二极管=晶體二極管
九谷泛年华=九谷泛年華
救民于水火=救民於水火
九陌故人游=九陌故人游
九山郁峥嵘=九山郁崢嶸
旧游成远道=舊游成遠道
旧游劳梦寐=舊游勞夢寐
旧游梁宋时=舊游梁宋時
旧游易磨灭=舊游易磨滅
倦游因解镳=倦游因解鑣
君子从游宦=君子從游宦
君子笃于亲=君子篤于親
菌子面食谱=菌子面食譜
君子亦党乎=君子亦党乎
君子于其言=君子于其言
开福宁禅师=開福甯禪師
坎壈倦游秦=坎壈倦游秦
看余度石桥=看余度石橋
堪与王孙游=堪與王孫游
康涅狄格州=康涅狄格州
肯尼罗杰斯=肯尼羅傑斯
空谷隆禅师=空谷隆禪師
空谷茂兰芷=空谷茂蘭芷
空谷清音起=空谷清音起
空余关陇恨=空余關隴恨
况乃正游梁=況乃正游梁
况是天游宫=況是天游宮
况游骢古道=況游驄古道
老者从公游=老者從公游
乐游形胜地=樂游形勝地
历乱递相扰=歷亂遞相擾
历乱多秋音=歷亂多秋音
历乱绮窗前=歷亂綺窗前
历落江山望=歷落江山望
两傻游天堂=兩傻游天堂
良游盛簪绂=良游盛簪紱
良游因时暇=良游因時暇
聊持数斗米=聊持數斗米
劣于山有阴=劣于山有陰
临床信息学=臨床資訊學
临当游南陂=臨當游南陂
林端但余黄=林端但余黃
邻家闻捣衣=鄰家聞擣衣
陵谷尚依然=陵谷尚依然
柳浪游泳场=柳浪遊泳場
留连惜余景=留連惜余景
硫赭曲菌素=硫赭麴菌素
龙池宁禅师=龍池甯禪師
龙身宁久藏=龍身甯久藏
卢布尔雅纳=盧布爾雅納
鲁谷村社区=魯谷村社區
銮游眺八区=鑾游眺八區
轮台风物异=輪台風物異
洛范九畴初=洛范九疇初
落魄游韩魏=落魄游韓魏
落日游南湖=落日游南湖
马提尼克岛=馬提尼克島
美人美于玉=美人美于玉
妹岳奈津美=妹岳奈津美
孟姜女变文=孟姜女變文
梦寐游蓬莱=夢寐游蓬萊
梦游的妈妈=夢游的媽媽
梦游清溪阴=夢游清溪陰
梦游小人国=夢游小人國
迷方客咸秦=迷方客咸秦
麋鹿姑苏游=麋鹿姑蘇游
米曲菌胰酶=米麴菌胰酶
免疫抑制药=免疫抑制藥
妙伎游金谷=妙伎游金穀
明时宁陆沉=明時甯陸沉
明朝游上苑=明朝游上苑
莫马尔法耶=莫馬爾法耶
模拟计算机=類比電腦
木姜叶冬青=木姜葉冬青
乃悟范生智=乃悟范生智
南游许过我=南游許過我
内斯特罗伊=内斯特羅伊
尼罗盘唇鲿=尼羅盤唇鱨
宁辞独晚荣=甯辭獨晚榮
宁分触石容=甯分觸石容
宁复想支机=甯複想支機
宁辜济物情=甯辜濟物情
宁关匠石顾=甯關匠石顧
宁关须采箓=甯關須采籙
宁归白云外=甯歸白雲外
宁怀别时苦=甯懷別時苦
宁冀少回鸾=甯冀少回鸞
宁劳动别容=甯勞動別容
宁劳攀桂枝=甯勞攀桂枝
宁劳耀金羁=甯勞耀金羈
宁媚于灶也=甯媚於灶也
宁栖野树林=甯棲野樹林
宁求白璧赉=甯求白璧賚
宁思江上老=甯思江上老
宁思玄豹情=甯思玄豹情
宁惟耕稼任=甯惟耕稼任
宁问春将夏=甯問春將夏
宁闻倚门夕=甯聞倚門夕
宁羡高阳池=甯羨高陽池
宁馨苑社区=甯馨苑社區
宁厌楚山曲=甯厭楚山曲
宁邀襄野童=甯邀襄野童
宁忆故池群=甯憶故池群
宁由贝锦诗=甯由貝錦詩
宁纡长者辙=甯紆長者轍
宁知巴峡路=甯知巴峽路
宁知白马来=甯知白馬來
宁知白日晚=甯知白日晚
宁知白社客=甯知白社客
宁知班定远=甯知班定遠
宁知傍淇水=甯知傍淇水
宁知府中吏=甯知府中吏
宁知还路赊=甯知還路賒
宁知江上兴=甯知江上興
宁知倦游者=甯知倦遊者
宁知乐九功=甯知樂九功
宁知穆天子=甯知穆天子
宁知人世里=甯知人世裡
宁知山东客=甯知山東客
宁知天子贵=甯知天子貴
宁知武陵趣=甯知武陵趣
宁知轩辕后=甯知軒轅後
宁知游子心=甯知遊子心
宁知沅水上=甯知沅水上
宁知赵飞燕=甯知趙飛燕
农夫舂旧谷=農夫舂舊谷
弄水游童棹=弄水游童棹
暖谷春光至=暖谷春光至
飘萧觉素发=飄蕭覺素髮
奇美拉手套=奇美拉手套
染谷由纪子=染谷由紀子
日比谷千岁=日比谷千歲
日举类游童=日舉類游童
融融于万户=融融于萬戶
如何千里外=如何千裡外
如何舞干戚=如何舞干戚
汝游心于淡=汝游心於淡
散步游林塘=散步游林塘
三点估算法=三點估算法
三津谷叶子=三津谷葉子
三年隔友于=三年隔友于
三移斗柄春=三移斗柄春
三友游甚熟=三友游甚熟
森乃希有子=森乃稀有子
杀龟以卜吉=殺龜以卜吉
霎岳楼笔谈=霎岳樓筆談
山川函谷路=山川函谷路
山窗游玉女=山窗游玉女
陕甘宁边区=陝甘寧邊區
山游仍水嬉=山游仍水嬉
伤心范桥水=傷心范橋水
赏游实贤王=賞游實賢王
少年且吏游=少年且吏游
少女风游兑=少女風游兌
少小客游梁=少小客游梁
涉谷麻里奈=涉谷麻裡奈
涉谷美智代=涉谷美智代
圣奥古斯丁=聖奧古斯丁
圣人藏于天=聖人藏于天
十倍质量程=十倍質量程
时看辟谷方=時看辟谷方
世联机械厂=世聯機械廠
石榴莲花散=石榴蓮花散
食宁妨解缆=食甯妨解纜
十日到咸秦=十日到咸秦
是时游夏辈=是時游夏輩
诗坛子有功=詩壇子有功
是为了解释=是為了解釋
使我升高台=使我升高台
实验现象是=實驗現象是
使用新菜单=使用新功能表
寿宁义禅师=壽甯義禪師
叔本华发现=叔本華發現
数据并行性=資料並行性
数据操纵网=資料操縱網
数据寄存器=資料寄存器
数据局部性=資料局部性
数据一致性=資料一致性
蜀山余方隐=蜀山余方隱
数数游何爽=數數游何爽
数字地震仪=數位地震儀
数字数据网=數位資料網
数字字符集=數字字元集
双去今来只=雙去今來隻
谁伴老人游=誰伴老人游
谁继卜商名=誰繼卜商名
思君心郁陶=思君心郁陶
似游华胥国=似游華胥國
四岳尚分忧=四岳尚分憂
送君函谷游=送君函谷遊
送秋千里雁=送秋千裡雁
素发干垂领=素髮幹垂領
素发随风扬=素髮隨風揚
苏叶厚朴汤=蘇葉厚朴湯
粟余三釜陈=粟余三釜陳
素于圆凿方=素于圓鑿方
遂登仙子谷=遂登仙子谷
索尔兹伯里=索爾茲伯里
所有權文件=所有權檔
他日曾游魏=他日曾游魏
叹汝于知己=歎汝于知己
坛余汉武基=壇余漢武基
绦镟光堪擿=絛鏇光堪擿
提剑郁匡时=提劍郁匡時
题于曲江路=題于曲江路
田村英里子=田村英裡子
恬和台上风=恬和台上風
天宁楷禅师=天甯楷禪師
天宁明禅师=天甯明禪師
忝游芝兰室=忝游芝蘭室
天岳昼禅师=天岳晝禪師
田中采地黄=田中埰地黃
同构型系统=同質性系統
同游得李生=同游得李生
同游即弟兄=同游即弟兄
同游锦水滨=同游錦水濱
同游英俊人=同游英俊人
徒烦思郁陶=徒煩思郁陶
图片的信息=圖片的資訊
徒郁仲举思=徒郁仲舉思
团粒状构造=團粒狀構造
退与夫子游=退與夫子游
脱父于严刑=脫父于嚴刑
万劫谷卫兵=萬劫谷衛兵
晚节嬉游简=晚節嬉游簡
万里边城地=萬裡邊城地
万里边城远=萬裡邊城遠
万宁桥社区=萬甯橋社區
顽朴谢镌锓=頑朴謝鐫鋟
望佛台山庄=望佛台山莊
王翰愿卜邻=王翰願卜鄰
王侯宁见拟=王侯甯見擬
王氏望岳楼=王氏望岳樓
王孙旧此游=王孫舊此游
王孙耐薄游=王孫耐薄游
王孙游不归=王孫游不歸
望厦山炮台=望廈山炮台
网游字众生=網游字眾生
未成游碧海=未成游碧海
唯解卜阴晴=唯解卜陰晴
未来信息战=未來資訊戰
惟怜万里外=惟憐萬裡外
位片计算机=位元片電腦
韦氏团水虱=韋氏團水蝨
惟余故苑石=惟余故苑石
唯余石桥在=唯余石橋在
温谷寒林薄=溫谷寒林薄
温谷媚新丰=溫谷媚新豐
文件状态表=檔狀態表
问交于子张=問交于子張
文酒娱游盛=文酒娛游盛
文书游夏徒=文書游夏徒
文王观于国=文王觀于國
文王观于臧=文王觀于臧
闻于韩侍郎=聞于韓侍郎
问于仲尼曰=問于仲尼曰
闻于竺乾师=聞于竺乾師
温州范茂水=溫州范茂水
我将游灵池=我將游靈池
我来空郁陶=我來空郁陶
我来游上国=我來游上國
蜗庐未卜安=蝸廬未卜安
我心胡郁陶=我心胡郁陶
我有一握发=我有一握髮
无本于为文=無本于為文
吾党谢王粲=吾党謝王粲
五谷田难种=五穀田難種
舞集仙台上=舞集仙台上
吴门绿波里=吳門綠波里
无闷余在林=無悶余在林
无心生复灭=無心生覆滅
吾兄方北游=吾兄方北游
吾再逐于鲁=吾再逐于魯
无准范禅师=無准范禪師
谿谷无异石=谿谷無異石
溪谷屡环周=溪谷屢環周
溪谷也增荣=溪谷也增榮
昔时歌舞台=昔時歌舞台
吸收复合体=吸收複合體
昔我游齐都=昔我游齊都
昔我游山东=昔我游山東
昔我游宋中=昔我游宋中
西游长安城=西游長安城
昔游秦雍间=昔游秦雍間
昔游蜀门下=昔游蜀門下
西余端禅师=西余端禪師
昔余迷学步=昔余迷學步
昔余涉漳水=昔余涉漳水
昔余卧林巷=昔余臥林巷
昔作咸秦客=昔作咸秦客
线程控制块=執行緒控制塊
咸称太子仁=咸稱太子仁
宪法性文件=憲法性檔
咸歌太平日=咸歌太平日
弦管宁容歇=弦管甯容歇
先进于礼乐=先進于禮樂
咸宁桂花糕=咸甯桂花糕
咸秦雾中失=咸秦霧中失
咸丘蒙问曰=咸丘蒙問曰
先生谷神者=先生谷神者
先生秀衡岳=先生秀衡岳
咸谓楚先贤=咸謂楚先賢
县西函谷路=縣西函谷路
咸享风味楼=咸享風味樓
咸言意气高=咸言意氣高
仙游光御路=仙游光禦路
仙游万乘来=仙游萬乘來
先游武子家=先游武子家
闲于为客时=閑于為客時
咸愿顾寒微=咸願顧寒微
乡党皆莫记=鄉党皆莫記
乡党敬何先=鄉党敬何先
乡党莫如齿=鄉党莫如齒
相看万里外=相看萬裡外
项目的效益=專案的效益
项目优先级=專案優先順序
乡心恨捣衣=鄉心恨擣衣
乡心正郁陶=鄉心正郁陶
相于契托饶=相于契托饒
小儿肺闭宁=小兒肺閉甯
小儿腹泻宁=小兒腹瀉甯
小儿感冒宁=小兒感冒甯
小儿健胃宁=小兒健胃甯
小儿解热宁=小兒解熱甯
小儿咳喘宁=小兒咳喘甯
小儿咳嗽宁=小兒咳嗽甯
小儿清热宁=小兒清熱甯
小儿吐泻宁=小兒吐瀉甯
小儿退热宁=小兒退熱甯
消渴游江汉=消渴游江漢
效益测算法=效益測算法
谢病客游梁=謝病客游梁
谢客开山后=謝客開山後
新承担项目=新承擔專案
新谷沙耶香=新谷沙耶香
新氢松软膏=新氫松軟膏
新生发育的=新生發育的
信息超负荷=資訊超負荷
信息流模型=資訊流模型
信息与传播=資訊與傳播
信息与电脑=資訊與電腦
信息与家庭=資訊與家庭
信息与经营=資訊與經營
信息与控制=資訊與控制
行不顾斗米=行不顧斗米
兴成只自适=興成隻自適
兴谷管委会=興谷管委會
兴谷园社区=興谷園社區
杏花游赵村=杏花游趙村
形天舞干戚=形天舞干戚
兄弟游吴国=兄弟游吳國
虚室罢游兰=虛室罷游蘭
学立游夏上=學立游夏上
雪满游春路=雪滿游春路
学余堂文集=學余堂文集
岩声中谷应=岩聲中谷應
宴游成野客=宴游成野客
言游高峰塔=言游高峰塔
妖气常郁温=妖氣常郁溫
一巴香水印=一巴香水印
移放于南湖=移放于南湖
倚剑登高台=倚劍登高台
依赖于包膜=依賴于包膜
一丘余枕石=一丘余枕石
一山宁禅师=一山甯禪師
衣裳垂素发=衣裳垂素髮
伊势谷友介=伊勢谷友介
忆昔游金谷=憶昔游金穀
忆昔游京华=憶昔游京華
已讶游何远=已訝游何遠
银川宁湘苑=銀川甯湘苑
银丝街面馆=銀絲街面館
殷于叶得霜=殷于葉得霜
婴儿保肺宁=嬰兒保肺甯
应怜范叔寒=應憐范叔寒
迎秋谷黍黄=迎秋谷黍黃
影象地质图=影像地質圖
用户状态表=使用者狀態表
永宁镇社区=永甯鎮社區
用钱不复数=用錢不複數
慵于嵇叔夜=慵于嵇叔夜
游遨乐相从=游遨樂相從
游步爱僧居=游步愛僧居
游楚复游燕=游楚複游燕
游楚妙弹开=游楚妙彈開
游得且须游=游得且須遊
游盖飘青云=游蓋飄青雲
游观绕林渠=游觀繞林渠
游华阳山图=游華陽山圖
游宦常往来=游宦常往來
游宦劳牵网=游宦勞牽網
游魂贷尔曹=游魂貸爾曹
游伎皆秾李=游伎皆穠李
游将跨蓬莱=游將跨蓬萊
游梁得主人=游梁得主人
游梁馆更添=游梁館更添
游梁竟惨凄=游梁竟慘淒
游梁且未遇=游梁且未遇
游目俯大江=游目俯大江
游女昔解佩=游女昔解佩
游秦遂不归=游秦遂不歸
游山忆谢公=游山憶謝公
游时怡讨论=游時怡討論
游随共尔曹=游隨共爾曹
游畋乐岁成=游畋樂歲成
游望亦裴回=游望亦裴回
游吴还入越=游吳還入越
游吴经万里=游吳經萬里
游夏遥相望=游夏遙相望
优游白虎殿=優遊白虎殿
友于存四海=友于存四海
友于皆挺拔=友于皆挺拔
由余窥霸国=由余窺霸國
游鱼时可见=游魚時可見
游于物之初=游于物之初
游鱼戏浅沙=游魚戲淺沙
游鱼自成族=游魚自成族
游赵村杏花=游趙村杏花
游止莲叶上=游止蓮葉上
游走肾危象=游走腎危象
于贝尔猎犬=于貝爾獵犬
余本燕赵人=余本燕趙人
余病长年悲=余病長年悲
余藏异隐沦=余藏異隱淪
预处理程序=預處理程式
于此饭王孙=于此飯王孫
于此命相知=于此命相知
余从伯鸾迈=余從伯鸞邁
余当投魏阙=余當投魏闕
郁岛藏深竹=郁島藏深竹
于道若童蒙=于道若童蒙
于道喜甘临=于道喜甘臨
余方炉峰下=余方爐峰下
预奉咸英奏=預奉咸英奏
与姑妈同游=與姑媽同游
寓谷志禅师=寓谷志禪師
愚谷智禅师=愚谷智禪師
于国有何劳=于國有何勞
余寒驾春风=余寒駕春風
愈合情合理=愈合情合理
郁花园社区=郁花園社區
余将归白社=余將歸白社
于嗟流景骏=于嗟流景駿
余今委修短=余今委修短
余扃牖而居=余扃牖而居
余论略施行=余論略施行
郁穆丝言重=郁穆絲言重
裕宁潮王府=裕寧潮王府
棫朴王之明=棫朴王之明
郁屈如长蛇=郁屈如長蛇
郁然怀君子=郁然懷君子
于山乎何有=于山乎何有
余稍为修萁=余稍為修萁
于身色有用=于身色有用
于时乏嘉闻=于時乏嘉聞
余事付钧陶=余事付鈞陶
于时国用富=于時國用富
于时忽命驾=于時忽命駕
于时见疣赘=于時見疣贅
余时忝南省=余時忝南省
余时忝诤臣=余時忝諍臣
余时游名山=余時遊名山
郁陶抱长策=郁陶抱長策
于啼泣之余=于啼泣之餘
余忝蓬山顾=余忝蓬山顧
余惟酒一钟=余惟酒一鐘
郁为尚书郎=郁為尚書郎
余闻古之人=余聞古之人
余闻星堕地=余聞星墮地
于我何有哉=于我何有哉
于焉聊自任=于焉聊自任
于焉微尚存=于焉微尚存
郁怏任盈虚=郁怏任盈虛
余亦东蒙客=余亦東蒙客
余亦赴京国=余亦赴京國
余亦浮于海=余亦浮於海
于役各勤王=于役各勤王
于役劳往还=于役勞往還
余亦能高咏=余亦能高詠
余亦师粲可=余亦師粲可
余亦忝诸孙=余亦忝諸孫
于役限维桑=于役限維桑
余亦谢时去=余亦謝時去
于予亦何有=于予亦何有
于予与何诛=于予與何誅
郁蒸何由开=郁蒸何由開
于中还自乐=于中還自樂
于中甚安适=于中甚安適
于中我自乐=于中我自樂
于兹閟幽玄=于茲閟幽玄
于兹任所惬=于茲任所愜
于兹万绪暌=于茲萬緒暌
于兹雅丽陈=于茲雅麗陳
原名姜德隐=原名姜德隱
原名沈岳焕=原名沈岳煥
原名余昭明=原名余昭明
愿言游泗水=願言游泗水
愿游薜叶下=願游薜葉下
越後谷耕平=越後谷耕平
岳麓海禅师=岳麓海禪師
月落捣衣边=月落擣衣邊
岳牧用词人=岳牧用詞人
岳雨连河细=岳雨連河細
粤余任推迁=粵余任推遷
粤余忝藩左=粵余忝藩左
云车游日华=雲車游日華
韵入捣衣声=韻入擣衣聲
属于田地的=屬於田地的
载酒游宛洛=載酒游宛洛
再游应眷眷=再游應眷眷
暂游阻词伯=暫游阻詞伯
葬于不毛地=葬于不毛地
藻绘忆游睢=藻繪憶游睢
曾参与游夏=曾參與游夏
展转更崩坏=輾轉更崩壞
展转岭猿鸣=輾轉嶺猿鳴
展转屡鸣鸡=輾轉屢鳴雞
展转伤怀抱=輾轉傷懷抱
展转遂达晨=輾轉遂達晨
展转仲宣哀=輾轉仲宣哀
仗剑清咸秦=仗劍清咸秦
掌上游戏机=掌上遊戲機
杖锡游王公=杖錫游王公
找到了解释=找到了解釋
诏发咸林兵=詔發咸林兵
赵尧宁易印=趙堯甯易印
震谷似雷惊=震谷似雷驚
真游践王豫=真游踐王豫
政逮于大夫=政逮于大夫
直城如斗柄=直城如斗柄
直道宁殊智=直道甯殊智
指令性计划=指令性計劃
只令游宦迟=只令游宦遲
智能化大厦=智慧化大廈
直视乐游苑=直視樂游苑
止脱生发散=止脫生發散
直望清波里=直望清波里
知余报国心=知余報國心
致于丹青地=致于丹青地
质之于巫咸=質之于巫鹹
制作难上请=制作難上請
仲尼畏于匡=仲尼畏于匡
忠朴受遗顾=忠朴受遺顧
周因于殷礼=周因于殷禮
昼游还荆吴=晝游還荊吳
朱夏云郁陶=朱夏雲郁陶
专用数据网=專用資料網
转于奴仆亲=轉于奴僕親
追踪信息素=追蹤資訊素
子华使于齐=子華使于齊
子击磬于卫=子擊磬于衛
自念咸秦客=自念咸秦客
孳生胡子孙=孳生胡子孫
自省游泉石=自省游泉石
自须游阮巷=自須游阮巷
兹游不可常=茲游不可常
兹游无时尽=茲游無時盡
作范宫闱睦=作范宮闈睦
佐游群英萃=佐游群英萃
坐知千里外=坐知千裡外
阿不都热合曼=﻿阿不都熱合曼
不汲汲于富贵=不汲汲于富貴
工程项目管理=工程項目管理
寡人之于国也=寡人之于國也
辽宁师范大学=遼寧師範大學
我的叔叔于勒=我的叔叔于勒
信息工程学院=信息工程學院
游蕲水清泉寺=游蘄水清泉寺
巴西埃拉电鳗=巴西艾拉電鰻
白色圆柱水虱=白色圓柱水蝨
倍他米松软膏=倍他米松軟膏
标准输入文件=標準輸入檔
博思百俊美发=博思百俊美發
不物于易者也=不物于易者也
陈添记恩宁路=陳添記恩甯路
串联机械密封=串聯機械密封
从我于陈蔡者=從我于陳蔡者
大块的硬面包=大塊的硬面包
大学城信息楼=大學城資訊樓
蛋白酶抑制药=蛋白酶抑制藥
德聪法宁二师=德聰法甯二師
德卡尔马尔戈=德卡爾馬爾戈
登高台而写忧=登高台而寫憂
地塞米松软膏=地塞米松軟膏
弟子何异于予=弟子何異于予
弟子无挹于前=弟子無挹于前
丁丑劫余印存=丁醜劫余印存
顶升管节制作=頂升管節制作
东谷黄粱夜舂=東谷黃粱夜舂
对象管理结构=物件管理結構
俄克拉何马州=奧克拉荷馬州
饿于首阳之下=餓于首陽之下
二十四只眼睛=二十四隻眼睛
管理信息系统=執行資訊系統
新喀里多尼亚=新赫里多尼亞
报表生成程序=報告產生器
标准输出文件=標準輸出檔
财务支持协议=財務支援協定
成本效益协议=成本效益協定
篡改信道信息=篡改通道資訊
待续数据标记=待續資料標記
当前默认目录=當前預設目錄
电子函件地址=電子函件位址
动态地址转换=動態位址轉換
多地址计算机=多位址電腦
访问控制列表=存取控制清單
分时用户方式=分時使用者方式
服务数据单元=服務資料單元
宫阁郁其沈沈=宮閣郁其沈沈
关系数据理论=關係資料理論
国际申请文件=國際申請檔
合成数字音频=合成數位音訊
宏流水线算法=巨集流水線演算法
混洗交换网络=混洗切換式網路
基金销售文件=基金銷售檔
交叉链接文件=交叉連結檔
旧游忆著山阴=舊游憶著山陰
卡斯特里特斯=卡斯翠特斯
空间数据编码=空間資料編碼
扩充数据输出=擴充資料輸出
鲁谷住宅社区=魯谷住宅社區
罗比埃利奥特=羅比伊里亞德
乐器数字接口=樂器數位介面
面向连接协议=連線導向協議
民岳小区社区=民岳社區社區
诺里奇犭更犬=諾里奇犬更犬
入侵检测系统=入侵偵測系統
实时数码数据=即時數碼資料
数据存取路径=資料存取路徑
数据高速通道=資料高速通道
数据控制语言=資料控制語言
数据网标识码=資料網標識碼
数字插值运算=數位插值運算
数字高程模型=數位高程模型
谁拿了录象带=誰拿了錄像帶
随机数生成器=亂數產生器
特定扣税项目=特定扣稅專案
投资项目风险=投資專案風險
图形用户界面=圖形化使用者介面
伪造信道信息=偽造通道資訊
文件分配时间=檔分配時間
系统管理文件=系統管理檔
项目范围管理=專案範圍管理
项目风险管理=專案風險管理
项目时间管理=專案時間管理
项目团队组建=專案團隊組建
信息理论基础=資訊理論基礎
页面描述语言=分頁描述語言
用户产权设备=使用者產權設備
用户文件目录=使用者檔目錄
远程过程调用=遠程程序呼叫
战略数据规划=戰略資料規劃
制定项目章程=制定專案章程
智能拍摄模式=智慧拍攝模式
朱利叶斯霍吉=朱利斯霍吉
资本组合数字=資本組合數位
阀位指示开关=閥位元指示開關
范高雷的爪子=范高雷的爪子
范古尔德内尔=范古爾德內爾
范集工业园区=范集工業園區
范尼斯特鲁伊=范尼斯特魯伊
范纽文胡伊曾=范紐文胡伊曾
范纽文胡伊泽=范紐文胡伊澤
范氏集古印谱=范氏集古印譜
反式杂基因子=反式雜基因子
范斯蒂恩伯格=范斯蒂恩伯格
反于白水之南=反于白水之南
范增数目项王=范增數目項王
范祖恩德尔特=范祖恩德爾特
丰富的信息量=豐富的信息量
符号位地震仪=符號位元地震儀
富宁天然食品=富甯天然食品
干砌块石桥台=幹砌塊石橋台
干砌毛石桥台=幹砌毛石橋台
高程控制测量=高程控制測量
高可宁绅士街=高可甯紳士街
高喷装置移位=高噴裝置移位元
高雅尖甲水虱=高雅尖甲水蝨
歌于斯哭于斯=歌于斯哭於斯
工程项目预算=工程項目預算
共生发光细菌=共生發光細菌
工啄基本项目=工啄基本專案
谷氨酰甘氨酸=谷氨醯甘氨酸
谷氨酰合成酶=谷氨醯合成酶
古巴圆柱水虱=古巴圓柱水蝨
鼓方叔入于河=鼓方叔入于河
古人寄景于诗=古人寄景于詩
故圣人有所游=故聖人有所游
光背节鞭水虱=光背節鞭水蝨
国家秘密文件=國家秘密檔
国民经济计划=國民經濟計劃
海口市制药厂=海口市制藥廠
合宁电工设备=合甯電工設備
衡岳楚云上人=衡岳楚雲上人
沪汉线合宁段=滬漢線合甯段
胡罗卜素单酮=胡羅卜素單酮
胡振岳妻徐氏=胡振岳妻徐氏
华岳玄伟禅师=華岳玄偉禪師
回旋转头运动=回旋轉頭運動
获取外界信息=獲取外界資訊
激光电子分色=激光電子分色
季氏旅于泰山=季氏旅于泰山
寂寿道人范氏=寂壽道人范氏
基思氏丽脂鲤=基斯氏麗脂鯉
计算机校验位=電腦校驗位元
佳宁娜狮子楼=佳甯娜獅子樓
渐西村舍汇刊=漸西村舍彙刊
浆砌块石桥台=漿砌塊石橋台
浆砌毛石桥台=漿砌毛石橋台
姜万郢村民组=姜萬郢村民組
姜汁过水牛肉=姜汁過水牛肉
交叉汇编程序=交叉組合程式
焦痕谷的符石=焦痕谷的符石
鹪鹩巢于深林=鷦鷯巢于深林
金谷东园社区=金谷東園社區
金谷香美食苑=金谷香美食苑
金谷园黄埔店=金穀園黃埔店
近乎卜祝之间=近乎卜祝之間
经常项目支出=經常項目支出
经带宁洁阴液=經帶甯潔陰液
荆棘谷的青山=荊棘谷的青山
荆棘谷迅猛龙=荊棘谷迅猛龍
晶体位错理论=晶體位元錯理論
净因惟岳禅师=淨因惟岳禪師
旧游飞燕能说=舊游飛燕能說
卷积投影数据=卷積投影資料
倦游欲去江上=倦游欲去江上
卷轴治疗能力=卷軸治療能力
卡范贝三氏病=卡范貝三氏病
考埃达席尔瓦=考艾達席爾瓦
克伯克于孜乡=克伯克于孜鄉
克鲁索洛克恩=克盧梭洛克恩
克洛卜施托克=克洛卜施托克
空谷禅师景隆=空谷禪師景隆
空间数据引擎=空間資料引擎
空间信息格网=空間資訊格網
昆仑山余家庄=昆侖山余家莊
乐可可巧克力=樂可哥巧克力
莉萨奥的护腕=麗莎奧的護腕
联邦党人文集=聯邦党人文集
练习用保险箱=練習用保險箱
卤美他松软膏=鹵美他松軟膏
氯氟舒松软膏=氯氟舒松軟膏
脉络宁口康片=脈絡甯口康片
孟孙问孝于我=孟孫問孝于我
密庵咸杰禅师=密庵咸傑禪師
米尔顿凯恩斯=米爾頓凱恩斯
面向对象语言=物件導向語言
敏于事慎于言=敏于事慎於言
没落于群雄中=沒落于群雄中
那天前那天后=那天前那天後
宁国谷歌卫浴=甯國谷歌衛浴
宁国健宁实业=甯國健甯實業
宁国力鑫工贸=寧國力鑫工貿
宁国新宁实业=甯國新甯實業
宁姜蒙古族乡=甯薑蒙古族鄉
宁启线林南线=甯啟線林南線
宁为夫子妾者=甯為夫子妾者
宁西线西合段=甯西線西合段
凝血级联系统=凝血級聯系統
宁阳电子科技=寧陽電子科技
宁移白首之心=甯移白首之心
平均访问时间=平均存取時間
朴隐禅师元净=朴隱禪師元淨
秦妈火锅济宁=秦媽火鍋濟甯
青浦信息学校=青浦資訊學校
人之役法于蒙=人之役法于蒙
日番谷冬狮郎=日番谷冬獅郎
三突蛀木水虱=三突蛀木水蝨
杀三苗于三危=殺三苗于三危
山河壮兮咸秦=山河壯兮咸秦
上颌窦曲菌病=上頜竇麴菌病
社会的信息化=社會的資訊化
舍于故人之家=舍于故人之家
神经控制作用=神經控制作用
深水平肩光鱼=深水平肩光魚
深圳市制药厂=深圳市制藥廠
世茂余山艾美=世茂余山艾美
实时操作系统=即時操作系統
食于苟简之田=食于苟簡之田
数据的可靠性=資料的可靠性
数据加密标准=資料加密標準
数据描述语言=資料描述語言
数据相关冲突=資料相關衝突
数字仿形控制=數位仿形控制
数字制作技术=數位製作技術
帅弟子而蹲于=帥弟子而蹲于
水平滑模施工=水平滑模施工
伺机待发雕文=伺機待髮雕文
嵩岳慧安国师=嵩岳慧安國師
嵩岳元圭禅师=嵩岳元圭禪師
唐卜陆西亚多=唐卜陸西亞多
桃源谷海鲜楼=桃源谷海鮮樓
特立尼达小鳀=千里達小鯷
通慧大师赞宁=通慧大師贊甯
投资项目评价=投資項目評價
图片需求信息=圖片需求資訊
图像文件格式=影像檔格式
网络体系结构=網路架構
网游梦幻现实=網游夢幻現實
位式控制作用=位式控制作用
惟孝友于兄弟=惟孝友于兄弟
微小圆柱水虱=微小圓柱水蝨
委一粒于万钟=委一粒于萬鐘
围于陈蔡之间=圍于陳蔡之間
文家永宁路口=文家永寧路口
文件检验程序=檔檢驗程式
我于青春无悔=我于青春無悔
吾愿游于其藩=吾願游於其藩
项目采购管理=專案採購管理
项目分解结构=專案分解結構
项目管理计划=項目管理計畫
项目团队管理=專案團隊管理
小儿广朴止泻=小兒廣朴止瀉
小儿咳宁糖浆=小兒咳甯糖漿
小于连救城记=小於連救城記
新发布依族乡=新發布依族鄉
新罕布什尔州=新罕布什爾州
信息存储技术=資訊存儲技術
信息工程学校=信息工程學校
信息净荷容量=資訊淨荷容量
信息浏览服务=資訊流覽服務
心智信息传送=心智資訊傳送
兴蒙蒙古族乡=興蒙蒙古族鄉
幸能听于吾师=幸能聽于吾師
休宁县萝宁街=休甯縣蘿寧街
虚拟专用网络=虛擬私人網路絡
虚堂禅师永宁=虛堂禪師永甯
延续生命支持=延續生命支援
洋风馆长宁店=洋風館長甯店
伊夫林矛非鲫=伊芙琳矛非鯽
忆桂树于南州=憶桂樹于南州
引发者信息素=引發者資訊素
用户特许文件=用戶特許檔
用户终端业务=使用者終端業務
游翠岩玑禅师=游翠岩璣禪師
游蓝田山卜居=游藍田山卜居
犹明于徐郎中=猶明于徐郎中
游莫逐炎洲翠=游莫逐炎洲翠
游平泉宴浥涧=游平泉宴浥澗
游平原赠晦叔=游平原贈晦叔
游夏兴兮鲁颜=游夏興兮魯顏
幽影谷月亮井=幽影谷月亮井
于从政乎何有=于從政乎何有
余弟安国平父=余弟安國平父
于贵之母于媪=于貴之母於媼
于湖居士文集=于湖居士文集
于家务村南口=于家務村南口
与门将一对一=與門將一對一
于人何所不容=于人何所不容
于斯三者何先=于斯三者何先
予死于道路乎=予死于道路乎
余为赞善大夫=余為贊善大夫
于易水送人绝=于易水送人絕
欲与元八卜邻=欲與元八卜鄰
于诸经独有书=于諸經獨有書
远程进程调用=遠端進程調用
远程控制软件=遠端控制軟體
远程邮件终端=遠端郵件終端
远程作业输出=遠端作業輸出
远程作业输入=遠端作業輸入
元素位面图腾=元素位元面圖騰
岳忠武王文集=岳忠武王文集
早夏游平原回=早夏游平原回
账外负债项目=賬外負債專案
浙江卫生信息=浙江衛生資訊
振幅检测组件=振幅檢測元件
治近宁眼药水=治近甯眼藥水
智能外围接口=智慧週邊介面
植物胚胎发生=植物胚胎發生
知游心于无穷=知游心於無窮
制造越位战术=製造越位元戰術
质子泵抑制药=質子泵抑制藥
中国信息大学=中國資訊大學
中医福宁分院=中醫福甯分院
侏儒喷火炮台=侏儒噴火炮台
专一只因为你=專一只因為你
庄子钓于濮水=莊子釣于濮水
字串行位并行=字串列位元並行
自动显示信息=自動顯示資訊
子贡南游于楚=子貢南游于楚
子贡贤于仲尼=子貢賢于仲尼
子路宿于石门=子路宿于石門
子游为武城宰=子游為武城宰
阿伏伽德罗常数=﻿阿伏伽德羅常數
此地空余黄鹤楼=此地空余黃鶴樓
放之四海而皆准=放之四海而皆準
牵一发而动全身=牽一髮而動全身
网游之近战法师=網游之近戰法師
网游之天谴修罗=網游之天譴修羅
网游之邪龙逆天=網游之邪龍逆天
信息与计算科学=資訊與計算科學
行成于思毁于随=行成于思毀於隨
郁孤台下清江水=郁孤台下清江水
于无声处听惊雷=于無聲處聽驚雷
八马入谷七马疲=八馬入谷七馬疲
白头重到太宁宫=白頭重到太甯宮
败席展转卧看经=敗席輾轉臥看經
百姓厨房咸宁店=百姓廚房咸甯店
暴发式物种形成=暴發式物種形成
褒公鄂公毛发动=褒公鄂公毛發動
北路余寒尚中人=北路余寒尚中人
奔流未已坑谷平=奔流未已坑谷平
比并余花发最迟=比並余花發最遲
卜邻尚可容三径=卜鄰尚可容三徑
卜商今日更修文=卜商今日更修文
卜葬于沙丘而吉=卜葬于沙丘而吉
卜筑江淮计已成=卜築江淮計已成
卜筑应同蒋诩径=卜築應同蔣詡徑
补衮于朝官尚卑=補袞于朝官尚卑
不将心嫁冶游郎=不將心嫁冶游郎
不求闻达于诸侯=不求聞達于諸侯
不嫌雾谷霾松柏=不嫌霧谷霾松柏
不信姬姜有齐鲁=不信姬姜有齊魯
不知薝卜是余香=不知薝卜是餘香
参天台五台山记=參天台五臺山記
沧江白发愁看汝=滄江白發愁看汝
苍生咸寿阴阳泰=蒼生咸壽陰陽泰
常于几成而败之=常于幾成而敗之
超低位速率编码=超低位元速率編碼
车箱入谷无归路=車箱入谷無歸路
陈亢问于伯鱼曰=陳亢問于伯魚曰
称意人间宁易得=稱意人間甯易得
程控数字测井仪=程式控制數位測井儀
城中斗米换衾裯=城中斗米換衾裯
虫鸡于人何厚薄=蟲雞于人何厚薄
愁中卜命看周易=愁中卜命看周易
处女绅士拆白党=處女紳士拆白党
传朴堂藏印菁华=傳朴堂藏印菁華
垂直条幅木板门=分隔號幅木板門
垂直于纸面向里=垂直于紙面向裡
垂直于纸面向外=垂直于紙面向外
春入穷谷多芳菲=春入窮谷多芳菲
此事不系于职司=此事不系于職司
此时顾恩宁顾身=此時顧恩甯顧身
慈游淡泊欢有余=慈游淡泊歡有餘
醋酸氟氢松软膏=醋酸氟氫松軟膏
翠谷玉景苑社区=翠谷玉景苑社區
大虎山炮台遗址=大虎山炮台遺址
大角山炮台遗址=大角山炮台遺址
大千只在脚下边=大千隻在腳下邊
打赢信息化战争=打贏資訊化戰爭
单倍二倍体循环=單倍二倍體迴圈
捣衣砧上拂还来=擣衣砧上拂還來
得复见将军于此=得複見將軍于此
德宁房地产开发=德甯房地產開發
等候董健华发落=等候董健華發落
低水平面泄水道=低水準面泄水道
弟子问于庄子曰=弟子問于莊子曰
点只捉贼咁简单=點隻捉賊咁簡單
东第只今空画像=東第隻今空畫像
东邻主人游不归=東鄰主人游不歸
东游久与故人违=東游久與故人違
斗柄未回犹带闰=斗柄未回猶帶閏
渡河问我游梁园=渡河問我游梁園
对象式编程语言=物件式程式設計語言
多学似君宁易得=多學似君甯易得
而游乎四海之外=而游乎四海之外
范贝二氏综合征=范貝二氏綜合征
范布隆克霍斯特=范布隆克霍斯特
范德斯特鲁伊克=范德斯特魯伊克
范德瓦耳斯方程=范德瓦耳斯方程
范霍二氏综合征=范霍二氏綜合征
范雎相秦倾九州=范雎相秦傾九州
范氏裸棘杜父鱼=范氏裸棘杜父魚
范斯安德格鲁姆=范斯安德格魯姆
范斯蒂恩布鲁格=范斯蒂恩布魯格
飞丝历乱如回风=飛絲歷亂如回風
沸汤空谷数道水=沸湯空谷數道水
分组交换数据网=封包交換數據網
峰峦窈窕谿谷黑=峰巒窈窕谿谷黑
复仇军中继数据=復仇軍中繼資料
付君此事宁论晋=付君此事甯論晉
服苗干羽舞两阶=服苗干羽舞兩階
富宁房地产开发=富甯房地產開發
夫子问于老聃曰=夫子問于老聃曰
柑果姜蕨交荆菅=柑果姜蕨交荊菅
干砌毛乱石桥台=幹砌毛亂石橋台
敢以状私于执事=敢以狀私于執事
更疑神女弄珠游=更疑神女弄珠游
更于酒里得天全=更于酒裡得天全
宫边老翁为余泣=宮邊老翁為余泣
公布或公告数据=公佈或公告資料
宫廷画师郎世宁=宮廷畫師郎世甯
谷城县谷伯中学=穀城縣谷伯中學
谷固醇达克罗宁=谷固醇達克羅寧
谷静山空右北平=谷靜山空右北平
故君子结于一也=故君子結于一也
谷里莺啼日暮时=谷裡鶯啼日暮時
固知余习未全忘=固知余習未全忘
谷中暗水响泷泷=谷中暗水響瀧瀧
管宁沧海寄余生=管甯滄海寄餘生
广德加谷湖林庄=廣德加谷湖林莊
国家计划委员会=國家計劃委員會
海宁良友大酒店=海甯良友大酒店
海畔居民饮咸苦=海畔居民飲咸苦
汉碑文范吴闿生=漢碑文范吳闓生
汉语言语信息库=漢語言語資訊庫
汉语语音信息库=漢語語音資訊庫
号泣于天于父母=號泣于天于父母
后会丁宁何日是=後會丁甯何日是
胡涂外父抢新郎=糊塗外父搶新郎
虎穴宁关射利探=虎穴甯關射利探
湖州上方岳禅师=湖州上方岳禪師
滑稽大王游沪记=滑稽大王游滬記
画师不复写名姓=畫師不複寫名姓
华岳先生尸解馀=華岳先生屍解餘
宦游莫作无家客=宦游莫作無家客
宦游直送江入海=宦游直送江入海
黄龙戍上游侠儿=黃龍戍上遊俠兒
回首旧游成古今=回首舊游成古今
即此陪欢游阆苑=即此陪歡游閬苑
姬姜本来舅甥国=姬姜本來舅甥國
江城卧听捣衣时=江城臥聽擣衣時
姜侯设脍当严冬=姜侯設膾當嚴冬
江宁县秦淮饭店=江甯縣秦淮飯店
浆砌方块石桥台=漿砌方塊石橋台
浆砌毛乱石桥台=漿砌毛亂石橋台
浆砌条料石桥台=漿砌條料石橋台
姜生记嘉林花园=姜生記嘉林花園
江苏方强制药厂=江蘇方強制藥廠
交游方笑党频频=交遊方笑黨頻頻
芥菜咸蛋鱼头汤=芥菜咸蛋魚頭湯
嗟余听鼓应官去=嗟余聽鼓應官去
嗟余闻道不早悟=嗟余聞道不早悟
金白领航天桥店=金白領航天橋店
金谷繁华石季伦=金谷繁華石季倫
金谷无烟宫树绿=金谷無煙宮樹綠
锦宁房地产开发=錦甯房地產開發
锦绣谷工业园区=錦繡谷工業園區
景宁金鹤大酒店=景甯金鶴大酒店
旧游怜我长沙谪=舊游憐我長沙謫
君方游宦从陈汝=君方游宦從陳汝
君宁不饮开君颜=君甯不飲開君顏
君宁久寄金谷地=君甯久寄金谷地
君取于吴为同姓=君取于吳為同姓
君于此外更何求=君于此外更何求
君子于其所不知=君子于其所不知
君子之于天下也=君子之于天下也
科里尔百科全书=寇里爾百科全書
客子倦游胡不归=客子倦游胡不歸
空肠结肠弯曲菌=空腸結腸彎麴菌
空谷耕田学子真=空谷耕田學子真
恐是半醉游青天=恐是半醉游青天
空使奸雄笑宁馨=空使奸雄笑甯馨
空余旧迹郁苍苍=空余舊跡鬱蒼蒼
哭向平生歌舞台=哭向平生歌舞台
况复迢迢千里外=況複迢迢千裡外
老卜奎东北农家=老卜奎東北農家
老范志万应神曲=老范志萬應神曲
老姜枸杞羊肉汤=老姜枸杞羊肉湯
老莱镇宽余林场=老萊鎮寬餘林場
乐谷婚恋交友网=樂谷婚戀交友網
乐全居士全于天=樂全居士全于天
乐游古园崒森爽=樂游古園崒森爽
历乱旌旗转云树=歷亂旌旗轉雲樹
历乱稍埋冰揉粟=歷亂稍埋冰揉粟
吏民走尽余王尊=吏民走盡余王尊
枥上空馀少游马=櫪上空餘少游馬
辽金元音乐史料=遼金元音樂史料
列奇偶校验字段=列同位欄位
劣于汉魏近风骚=劣于漢魏近風騷
菱暖紫鳞跳复没=菱暖紫鱗跳覆沒
灵山宁与心为仇=靈山甯與心為仇
灵隐松源岳禅师=靈隱松源岳禪師
龙游金穗大酒店=龍游金穗大酒店
楼上阑干横斗柄=樓上闌幹橫斗柄
露冷遥知范叔寒=露冷遙知范叔寒
罗罗嗦嗦草莓汁=羅囉嗦嗦草莓汁
落拓旧游应记得=落拓舊游應記得
麦短未怕游车轮=麥短未怕遊車輪
敏于事而慎于言=敏于事而慎於言
明明天子咸戒之=明明天子咸戒之
明天在亚拉巴马=明天在阿拉巴馬
默林的神秘商店=梅林的神秘商店
模拟数字转换器=類比數位轉換器
南家捣衣动归客=南家擣衣動歸客
南宁国际大酒店=南寧國際大酒店
南宁南方大酒店=南寧南方大酒店
南游花柳塞云烟=南游花柳塞雲煙
宁海长街海鲜楼=甯海長街海鮮樓
宁生而曳尾涂中=甯生而曳尾塗中
宁氏舅甥俱寂寞=甯氏舅甥俱寂寞
宁馨苑小区南门=甯馨苑社區南門
宁羞白发照清水=甯羞白髮照清水
宁知宿昔恩华乐=甯知宿昔恩華樂
潘岳悼亡犹费词=潘岳悼亡猶費詞
普宁华侨管理区=普甯華僑管理區
清炖姜归羊肉汤=清燉姜歸羊肉湯
氢化可的松软膏=氫化可的松軟膏
氢化泼尼松软膏=氫化潑尼松軟膏
人影动摇绿波里=人影動搖綠波里
伺于君子有三愆=伺于君子有三愆
三角头喜铃水虱=三角頭喜鈴水蝨
三千里外巴南恨=三千裡外巴南恨
三千里外巴蛇穴=三千裡外巴蛇穴
三千里外寄欢来=三千裡外寄歡來
三千里外老江城=三千裡外老江城
三千里外思裴回=三千裡外思裴回
三千里外卧江州=三千裡外臥江州
三千里外远行人=三千裡外遠行人
沙苯立克复合散=沙苯立克複合散
山鸟山花吾友于=山鳥山花吾友于
摄提贞于孟陬兮=攝提貞于孟陬兮
沈范早知何水部=沈范早知何水部
深坊静岸游应遍=深坊靜岸游應遍
深涧游鱼乐不知=深澗游魚樂不知
申宁房地产开发=申甯房地產開發
深山穷谷委严霜=深山窮谷委嚴霜
深于同在翰林时=深于同在翰林時
生别展转不相见=生別輾轉不相見
生活好坏于一心=生活好壞于一心
圣人不从事于务=聖人不從事于務
试卜鱼牛那至此=試卜魚牛那至此
师不必贤于弟子=師不必賢于弟子
诗词曲语词汇释=詩詞曲語詞匯釋
十二月党人文学=十二月党人文學
实藉严君卖卜钱=實藉嚴君賣卜錢
石家金谷重新声=石家金谷重新聲
视觉模拟评分法=視覺類比評分法
是求马于唐肆也=是求馬于唐肆也
石渠金谷中间路=石渠金谷中間路
时人不识余心乐=時人不識余心樂
使汝未老华发生=使汝未老華發生
蜀客曾游明月峡=蜀客曾游明月峽
数字模拟计算机=數位類比電腦
谁従我游颜氏子=誰従我游顏氏子
水满陂塘谷满篝=水滿陂塘谷滿篝
水元素位面之链=水元素位元面之鏈
舜持干羽苗革心=舜持干羽苗革心
舜于戴晋人之前=舜于戴晉人之前
四贤镇岳宁边徼=四賢鎮岳甯邊徼
四岳不敢施烦苛=四岳不敢施煩苛
宋僧统赞宁法师=宋僧統贊甯法師
送萧处士游黔南=送蕭處士游黔南
嵩岳破灶堕和尚=嵩岳破灶墮和尚
搜于岐阳骋雄俊=搜于岐陽騁雄俊
素发联华惊老大=素髮聯華驚老大
睢宁县城西小学=睢甯縣城西小學
睢宁县实验小学=睢甯縣實驗小學
他日卜邻先有约=他日卜鄰先有約
太宰问于子贡曰=太宰問于子貢曰
桃花历乱李花香=桃花歷亂李花香
特立尼达岛毛鲶=千里達島毛鯰
天福苑崇宁路店=天福苑崇甯路店
天宁寺北里社区=天甯寺北裡社區
天宁寺二热社区=天甯寺二熱社區
天宁寺南里社区=天甯寺南裡社區
童党之街头霸王=童党之街頭霸王
统计过程控制图=統計程序控制圖
瓦讷舌鳞银汉鱼=瓦納舌鱗銀漢魚
万劫谷束皮腕甲=萬劫谷束皮腕甲
网关到网关协议=閘道到閘道協定
网游之夺宝专家=網游之奪寶專家
网游之风流骑士=網游之風流騎士
网游之混沌初开=網游之混沌初開
网游之梦幻现实=網游之夢幻現實
网游之天生废物=網游之天生廢物
网游之屠龙巫师=網游之屠龍巫師
网游之完美世界=網游之完美世界
网游之永生传奇=網游之永生傳奇
网游之再塑人生=網游之再塑人生
网游之职业人生=網游之職業人生
位串行信息公路=位元串列資訊公路
为感君王展转思=為感君王輾轉思
微机远程控制柜=微機遠端控制櫃
惟见乌帽出复没=惟見烏帽出覆沒
唯忧盗贼今好卜=唯憂盜賊今好卜
为余骑马习家池=為余騎馬習家池
为余投檄向江西=為余投檄向江西
问君西游何当还=問君西游何當還
我卜郊居避俗憎=我卜郊居避俗憎
我独展转何时明=我獨輾轉何時明
握发呼儿延入户=握髮呼兒延入戶
我官于南今几时=我官于南今幾時
蜗壳卜居心自放=蝸殼蔔居心自放
蜗殻卜居心自放=蝸殻蔔居心自放
握手宁知无贺监=握手甯知無賀監
我愿卜邻非一日=我願卜鄰非一日
五层防水平池底=五層防水平池底
吾党之小子狂简=吾党之小子狂簡
吾将曳尾于涂中=吾將曳尾于塗中
吾君不游有深意=吾君不游有深意
屋企汤馆长宁店=屋企湯館長甯店
梧桐坠叶捣衣催=梧桐墜葉擣衣催
物外长悬海岳期=物外長懸海岳期
物外真游来几席=物外真游來幾席
吾游心于物之初=吾游心于物之初
戏蝶游蜂乱入房=戲蝶游蜂亂入房
喜逢二室游仙子=喜逢二室游仙子
喜奉仙游归路远=喜奉仙游歸路遠
溪谷溅溅嫩水通=溪谷濺濺嫩水通
喜于身得省郎时=喜于身得省郎時
下谷平土家族乡=下谷平土家族鄉
下穷溪谷上通天=下窮溪谷上通天
咸蛋节瓜鱼尾汤=咸蛋節瓜魚尾湯
先生卜筑临清济=先生卜築臨清濟
鲜于仲通六万卒=鮮于仲通六萬卒
项目的无形效益=專案的無形效益
襄阳谷隐显禅师=襄陽谷隱顯禪師
小儿暑感宁糖浆=小兒暑感甯糖漿
小年为写游梁赋=小年為寫游梁賦
小于潘岳头先白=小於潘岳頭先白
携手与君游最乐=攜手與君游最樂
新方要妙得于陈=新方要妙得于陳
新华社鲁谷社区=新華社魯谷社區
新欢便饱姜侯德=新歡便飽姜侯德
新生儿贲门松驰=新生兒賁門鬆馳
信息与通信理论=資訊與通信理論
性心理发育障碍=性心理發育障礙
休宁县海阳饭店=休甯縣海陽飯店
休宁县石林宾馆=休甯縣石林賓館
须知个个出于蓝=須知個個出於藍
雪里欢游莫厌频=雪裡歡游莫厭頻
血卫士希尼瓦讷=血衛士希尼瓦納
亚拉巴马黑猪鱼=阿拉巴馬黑豬魚
宴余香满上书囊=宴余香滿上書囊
尧让天下于许由=堯讓天下于許由
野谷流泉添入池=野谷流泉添入池
业余高手对局集=業餘高手對局集
易卜拉希马陶尔=易卜拉希馬陶爾
已曾衡岳送苏耽=已曾衡岳送蘇耽
伊夫林短线脂鲤=伊芙琳短線脂鯉
伊夫林鮈鰕虎鱼=伊芙琳鮈鰕虎魚
一豁明主正郁陶=一豁明主正郁陶
忆旧游寄刘苏州=憶舊游寄劉蘇州
饮我宁辞酒或索=飲我甯辭酒或索
颍谷封人羞自荐=潁谷封人羞自薦
萦沙惹草细于毛=縈沙惹草細于毛
影象增强显微术=影像增強顯微術
用户建筑群设备=使用者建築群設備
犹川谷之于江海=猶川谷之于江海
游舫已妆吴榜稳=游舫已妝吳榜穩
有恒产者有恒心=有恆產者有恒心
游花冠盖日相望=游花冠蓋日相望
游女飘飖思解佩=游女飄颻思解佩
游山弄水携诗卷=游山弄水攜詩卷
游襄阳怀孟浩然=游襄陽懷孟浩然
游依二室成三友=游依二室成三友
犹有太师歌舞台=猶有太師歌舞台
游鱼鱍鱍莲田田=游魚鱍鱍蓮田田
游鱼瞥瞥双钓童=游魚瞥瞥雙釣童
游钟山大爱敬寺=游鐘山大愛敬寺
于此得全非至乐=于此得全非至樂
雨後余花满地存=雨後余花滿地存
余嘉其能行古道=余嘉其能行古道
于家园二区社区=于家園二區社區
寓禁于征的税项=寓禁于征的稅項
余烈尚能开後世=余烈尚能開後世
雨笼衡岳是南山=雨籠衡岳是南山
余情付湖水湖烟=余情付湖水湖煙
余亦乘舟归鹿门=余亦乘舟歸鹿門
余亦扁舟湘水阴=余亦扁舟湘水陰
余亦沙边具小舟=余亦沙邊具小舟
雨余风物便萧然=雨余風物便蕭然
于越城边枫叶高=于越城邊楓葉高
预制窗口墙单元=預製視窗牆單元
怨别自惊千里外=怨別自驚千裡外
远程数据库访问=遠端資料庫訪問
愿为愚谷烟霞侣=願為愚谷煙霞侶
岳石款记如湘崖=岳石款記如湘崖
月照松时台上行=月照松時台上行
云断岳莲临大路=雲斷岳蓮臨大路
云卧山游去未迟=雲臥山游去未遲
曾不得献于君王=曾不得獻于君王
曾于太白峰前住=曾于太白峰前住
曾逐仙人游碧落=曾逐仙人游碧落
在客体化的对象=在客體化的物件
在线条的运用上=在線條的運用上
再游巫峡知何日=再游巫峽知何日
暂游还忆崔先辈=暫游還憶崔先輩
贼臣恶子休干纪=賊臣惡子休干紀
詹姆斯奥布雷恩=詹姆斯奧布雷恩
昭阳殿下捣衣声=昭陽殿下擣衣聲
郑有神巫曰季咸=鄭有神巫曰季咸
只爱欢游两京路=只愛歡游兩京路
指挥猛将收咸京=指揮猛將收咸京
智能方向传感器=智慧方向感測器
智能机械研究所=智慧機械研究所
致仕崔卿拟卜邻=致仕崔卿擬卜鄰
仲尼问于大史大=仲尼問于大史大
众罔两问于景曰=眾罔兩問于景曰
周亡天下传于隋=周亡天下傳于隋
主人为卜林塘幽=主人為卜林塘幽
主战武器智能化=主戰武器智慧化
椎冰看捣万谷皮=椎冰看搗萬谷皮
字成只畏盘龙去=字成隻畏盤龍去
字母数字字符集=字母數位字元集
子禽问于子贡曰=子禽問于子貢曰
紫塞宁论尚有霜=紫塞甯論尚有霜
纵有旧游君莫忆=縱有舊游君莫憶
昨夜离心正郁陶=昨夜離心正郁陶
成都信息工程学院=成都資訊工程學院
宁为玉碎不为瓦全=甯為玉碎不為瓦全
青出于蓝而胜于蓝=青出於藍而勝於藍
特立尼达和多巴哥=千里達和多巴哥
败事有余成事不足=敗事有餘成事不足
办理文件副本请求=辦理檔副本請求
保加利亚萨瓦讷鳅=保加利亞薩瓦納鰍
北京信息工程学院=北京資訊工程學院
国际日期变更线=國際換日線
巴伦西亚帕梅萨=巴倫西亞帕梅薩山
超文本传输协议=超文字傳輸協定
单色显示适配器=單色顯示介面卡
电路交换数据网=電路交換資料網
对象链接与嵌入=物件連結與嵌入
多用户操作系统=多使用者作業系統
分布式对象技术=分散式物件技術
复仇军数据单元=復仇軍資料單元
国际标准化组织=國際標準組織
吉奥纳塔米高奇=吉奧納泰咪高奇
结构化编辑程序=結構編輯程式
精选交易商协议=精選交易商協定
卡桑德拉的炼狱=卡珊多拉的煉獄
马尔维纳斯群岛=福克蘭群島
汝等岂知蒙帝力=汝等豈知蒙帝利
数字视频特技机=數位視訊特技機
瓦伦西亚帕梅萨=瓦倫西亞帕梅薩山
系统性能监视器=系統效能監視器
心知帝力同天地=心知帝利同天地
英属维尔京群岛=英屬維京群島
曾侍土阶知帝力=曾侍土階知帝利
制造自动化协议=製造自動化協定
北门成问于黄帝曰=北門成問于黃帝曰
丙酸倍氯米松软膏=丙酸倍氯米松軟膏
不矜于同而矜于治=不矜于同而矜於治
程序设计支持环境=程式設計支援環境
费里斯史二氏手术=費理斯史二氏手術
高级数据链路控制=高階資料連結控制
绩溪宏源电力工程=績溪巨集源電力工程
逻辑链路控制协议=邏輯鏈路控制協定
数据电路终接设备=資料電路終接設備
铁电非易失存储器=鐵電非動態記憶體
网络新闻传送协议=網路新聞傳送協定
项目人力资源管理=專案人力資源管理
智能场景识别系统=智慧場景識別系統
中央数字摄影频道=中央數位攝影頻道
自动摄影目标图像=自動攝影靶心圖表像
常宁市龙王山金矿=常甯市龍王山金礦
常州市永宁楼饭店=常州市永甯樓飯店
川山甲鲜椒仔姜王=川山甲鮮椒仔姜王
串行线路网际协议=串列線路網際協定
川渝乡土菜朴淳居=川渝鄉土菜朴淳居
醋酸曲安缩松软膏=醋酸曲安縮松軟膏
长有游幽人悲晋惠=長有游幽人悲晉惠
大明空谷景隆禅师=大明空谷景隆禪師
达于理者必明于权=達于理者必明于權
达于情而遂于命也=達于情而遂於命也
代码中文转换文件=代碼中文轉換檔
单回路数字控制器=單回路數字控制器
德罗特宁霍尔摩宫=德羅特甯霍爾摩宮
得至美而游乎至乐=得至美而游乎至樂
得之于手而应于心=得之于手而應於心
多八位编码字符集=多八位元編碼字元集
法于阴阳以朴应冗=法于陰陽以朴應冗
范冰冰主演封神榜=范冰冰主演封神榜
范氏驼背无齿脂鲤=范氏駝背無齒脂鯉
范谢爱三氏综合征=范謝愛三氏綜合征
非抗于九国之师也=非抗于九國之師也
丰宁海鲜金南路店=豐甯海鮮金南路店
风险投资公司文件=風險投資公司檔
浮力液位测量装置=浮力液位元測量裝置
肤舒宁草本精华液=膚舒甯草本精華液
夫子固拙于用大矣=夫子固拙于用大矣
夫子何不谭我于王=夫子何不譚我于王
甘青宁新藏五省区=甘青甯新藏五省區
敢昭告于皇皇后帝=敢昭告於皇皇後帝
公孙龙问于魏牟曰=公孫龍問于魏牟曰
谷氨酰胺酰合成酶=谷氨醯胺醯合成酶
谷口书斋寄杨补阙=谷口書齋寄楊補闕
故往贷粟于监河侯=故往貸粟于監河侯
广宁县华侨大酒店=廣甯縣華僑大酒店
广州软件信息广场=廣州軟體資訊廣場
国内申请提交数据=國內申請提交資料
哈吉库马尔沙布旦=哈吉庫馬爾沙布旦
海宁市华联大酒店=海甯市華聯大酒店
海宁市顺利园饭店=海甯市順利園飯店
海宁市友好大酒店=海甯市友好大酒店
海运则将徙于南冥=海運則將徙于南冥
憨山大师梦游全集=憨山大師夢游全集
汉字信息特征编码=漢字資訊特徵編碼
汉字信息压缩技术=漢字資訊壓縮技術
和马叔度游月波楼=和馬叔度游月波樓
湖州西余净端禅师=湖州西余淨端禪師
黄姜丰产栽培技术=黃薑豐產栽培技術
皇览揆余于初度兮=皇覽揆余于初度兮
济宁市常红大酒店=濟甯市常紅大酒店
济宁师范专科学校=濟寧師範專科學校
济宁市华源大酒店=濟甯市華源大酒店
济宁市亚洲大酒店=濟甯市亞洲大酒店
健宁园林绿化工程=健甯園林綠化工程
建筑工程项目管理=建築工程專案管理
姜堰市太白大酒店=姜堰市太白大酒店
可编程控制计算机=可程式設計控制電腦
克罗宁娄二氏反应=克羅甯婁二氏反應
龙游县东华大酒店=龍游縣東華大酒店
龙游县龙通大酒店=龍游縣龍通大酒店
龙游县阳光大酒店=龍游縣陽光大酒店
罗兵咸永道会计师=羅兵咸永道會計師
每次都有领导出席=每次都有領導出席
明瓯宁发吾张居士=明甌甯發吾張居士
宁巴山自然保护区=甯巴山自然保護區
宁都县金谷大酒店=甯都縣金穀大酒店
宁都县水东工业园=甯都縣水東工業園
宁国格尔橡塑制品=寧國格爾橡塑製品
宁泰安全技术培训=甯泰安全技術培訓
宁为鸡口不为牛后=甯為雞口不為牛後
宁为鸡口无为牛后=甯為雞口無為牛後
宁为鸡口毋为牛后=甯為雞口毋為牛後
宁乡县华星大酒店=甯鄉縣華星大酒店
女黑侠血战黄龙党=女黑俠血戰黃龍党
配合财务做好数据=配合財務做好資料
普宁市安华大酒店=普甯市安華大酒店
普宁市宏华大酒店=普甯市宏華大酒店
普宁市金兴大酒店=普甯市金興大酒店
普宁市阳华大酒店=普甯市陽華大酒店
普宁市玉华大酒店=普甯市玉華大酒店
乔发乳制品经销部=喬發乳製品經銷部
青萝卜陈皮煲鸭汤=青蘿蔔陳皮煲鴨湯
若于夫子之所言矣=若于夫子之所言矣
三年无改于父之道=三年無改于父之道
圣天德烟台风味楼=聖天德煙臺風味樓
识之于近役之于远=識之于近役之於遠
数字式综合测井仪=數位式綜合測井儀
四川新华发行集团=四川新華發行集團
四川信息工程学校=四川資訊工程學校
搜于国中三日三夜=搜于國中三日三夜
睢宁县官山乡饭店=睢甯縣官山鄉飯店
虽攘先天后天之法=雖攘先天後天之法
孙悟空大闹女人谷=孫悟空大鬧女人谷
叹后约丁宁竟何据=歎後約丁甯竟何據
特立尼达和多哥巴=千里達和多哥巴
天宁寺电管局社区=天甯寺電管局社區
听于源泉而乐水也=聽于源泉而樂水也
潼川府天宁则禅师=潼川府天甯則禪師
外婆桥宁波私方菜=外婆橋寧波私方菜
网游之乞丐也疯狂=網游之乞丐也瘋狂
网游之星际执政官=網游之星際執政官
惟夫党人之偷乐兮=惟夫党人之偷樂兮
我且南游吴越之王=我且南游吳越之王
武汉华美达光谷达=武漢華美達光谷達
无恒产而有恒心者=無恆產而有恒心者
五台普宁弘教大师=五台普甯弘教大師
无天于上无地于下=無天于上無地於下
吾与夫子游十九年=吾與夫子游十九年
下面叙述正确的是=下面敘述正確的是
香炉峰下新卜山居=香爐峰下新卜山居
小儿百服宁口服液=小兒百服甯口服液
新宁县金城大酒店=新甯縣金城大酒店
信息与危机的经济=資訊與危機的經濟
新余高等专科学校=新餘高等專科學校
兴宁市宁安大酒店=興甯市甯安大酒店
休宁县齐云山宾馆=休甯縣齊雲山賓館
虚拟设备驱动程序=虛擬裝置驅動程式
雪岳山烧烤六路店=雪岳山燒烤六路店
叶公问孔子于子路=葉公問孔子于子路
易卜拉希马迪亚洛=易卜拉希馬迪亞洛
易卜拉希马卡马拉=易卜拉希馬卡馬拉
邑于岐山之下居焉=邑于岐山之下居焉
因特网信息服务器=網際網路資訊伺服器
英雄的梦游者长裤=英雄的夢游者長褲
英雄的梦游者长袍=英雄的夢游者長袍
英雄的梦游者衬肩=英雄的夢游者襯肩
英雄的梦游者护手=英雄的夢游者護手
英雄的梦游者护腿=英雄的夢游者護腿
英雄的梦游者肩垫=英雄的夢游者肩墊
英雄的梦游者肩甲=英雄的夢游者肩甲
英雄的梦游者手甲=英雄的夢游者手甲
英雄的梦游者手套=英雄的夢游者手套
英雄的梦游者头盔=英雄的夢游者頭盔
英雄的梦游者头饰=英雄的夢游者頭飾
英雄的梦游者腿甲=英雄的夢游者腿甲
英雄的梦游者外套=英雄的夢游者外套
英雄的梦游者外衣=英雄的夢游者外衣
英雄的梦游者罩帽=英雄的夢游者罩帽
勇特务大战神秘党=勇特務大戰神秘党
游南岩和范廓之韵=游南岩和範廓之韻
又一家湖南面粉坊=又一家湖南面粉坊
于长寿寺说法度人=于長壽寺說法度人
余公孙大娘弟子也=余公孫大娘弟子也
与指定计划有关的=與指定計劃有關的
远程实时取景功能=遠端即時取景功能
远程信息处理信息=遠端資訊處理資訊
远程作业处理程序=遠端作業處理常式
岳上岳洞庭水水庭=岳上岳洞庭水水庭
云舒仔姜王双楠店=雲舒仔姜王雙楠店
云舒仔姜王玉林店=雲舒仔姜王玉林店
早春忆游思黯南庄=早春憶游思黯南莊
昭月和尚之母余媪=昭月和尚之母余媼
至激于义理者不然=至激于義理者不然
脂降宁片安络宁片=脂降甯片安絡寧片
智能家居布线系统=智慧家居佈線系統
植入人工晶体异位=植入人工晶體異位元
周三藏攘那跋陀罗=周三藏攘那跋陀羅
庄周游于雕陵之樊=莊周遊于雕陵之樊
锥面包络环面蜗杆=錐面包絡環面蝸杆
锥面包络圆柱蜗杆=錐面包絡圓柱蝸杆
阿里巴巴与四十大盗=﻿阿裡巴巴與四十大盜
比好游者尚不能十一=比好游者尚不能十一
伯夷死名于首阳之下=伯夷死名于首陽之下
被发行歌而游于塘下=被發行歌而游於塘下
醋酸氟氢可的松软膏=醋酸氟氫可的松軟膏
大话西游三主角故事=大話西游三主角故事
大话西游之月光宝盒=大話西游之月光寶盒
单列直插式内存组件=單列直插式記憶體元件
地图标注式战斗命令=地圖標注式戰鬥命令
超级视频图形适配器=超級視訊圖形介面卡
多点二进制文件传送=多點二進位檔案傳送
国际申请的申请数据=國際申請的申請資料
简便的目录访问协议=簡便的目錄訪問協定
人的本质力量对象化=人的本質力量物件化
项目的经济换汇成本=專案的經濟換匯成本
地形等高线匹配制导=地形等高線匹配制導
电脑数据自动交换网=電腦資料自動交換網
电子对抗模拟试验场=電子對抗類比試驗場
而不得极夫游之乐也=而不得極夫游之樂也
樊迟从游于舞雩之下=樊遲從游於舞雩之下
范宁卢博克血红蛋白=范甯盧博克血紅蛋白
范辛格勒二氏综合征=范辛格勒二氏綜合征
防信息泄漏控制范围=防資訊洩漏控制範圍
福建宁化金叶大酒店=福建甯化金葉大酒店
睾丸支持间质细胞瘤=睾丸支援間質細胞瘤
公伯寮诉子路于季孙=公伯寮訴子路于季孫
故圣人观于天而不助=故聖人觀于天而不助
观于浊水而迷于清渊=觀于濁水而迷於清淵
国际申请的公布数据=國際申請的公佈資料
国际信息学奥林匹克=國際資訊學奧林匹克
国脉信息运营分公司=國脈資訊運營分公司
海宁市庆云华丰饭店=海甯市慶雲華豐飯店
海宁市硖石顺风饭店=海甯市硤石順風飯店
海宁斜桥东亚大酒店=海甯斜橋東亞大酒店
河北医科大学制药厂=河北醫科大學制藥廠
淮安市范集合作饭店=淮安市范集合作飯店
极大项范式合取范式=極大項范式合取範式
极小项范式析取范式=極小項范式析取範式
姜堰市王石美味饭店=姜堰市王石美味飯店
明于权者不以物害己=明于權者不以物害己
模拟磁带记录强震仪=類比磁帶記錄強震儀
模拟人生趴趴走系列=類比人生趴趴走系列
南伯子綦游乎商之丘=南伯子綦游乎商之丘
宁墩山河粮油加工厂=甯墩山河糧油加工廠
宁国邦宁房地产开发=甯國邦甯房地產開發
烧伤面积手掌估算法=燒傷面積手掌估算法
沈阳万邦信息大酒店=瀋陽萬邦資訊大酒店
石家庄信息工程学院=石家莊資訊工程學院
市信息化工作办公室=市資訊化工作辦公室
手续文件审批通知书=手續檔審批通知書
舒血宁银杏叶注射液=舒血甯銀杏葉注射液
双列直插式内存组件=雙列直插式記憶體元件
宋建阳廌山游先生酢=宋建陽廌山游先生酢
宋瓯宁竹源宗元庵主=宋甌甯竹源宗元庵主
睢宁县小博士幼儿园=睢甯縣小博士幼稚園
万宁兴隆康乐大酒店=萬甯興隆康樂大酒店
卫公孙朝问于子贡曰=衛公孫朝問于子貢曰
武进市卜弋绿叶饭店=武進市卜弋綠葉飯店
乌盟集宁市辽原饭店=烏盟集甯市遼原飯店
吴清源全集之白布局=吳清源全集之白布局
咸欖煲茶白欖冇得解=咸欖煲茶白欖冇得解
兴宁市狗肉王大酒店=興甯市狗肉王大酒店
伊藤润二之鬼卜怪谈=伊藤潤二之鬼卜怪談
组件式地理信息系统=元件式地理資訊系統
遵化市党峪普兰饭店=遵化市党峪普蘭飯店
遵化市党峪同富饭店=遵化市党峪同富飯店
昨天晚上的分手电话=昨天晚上的分手電話
被伤过的心还可以爱谁=﻿被傷過的心還可以愛誰
白求恩医科大学制药厂=白求恩醫科大學制藥廠
颁白者不负戴于道路矣=頒白者不負戴于道路矣
不似尔向之自多于水乎=不似爾向之自多於水乎
臣不奏前三皇后代五帝=臣不奏前三皇後代五帝
地方市政债券数据机构=地方市政債券資料機構
东北大学东软信息学院=東北大學東軟資訊學院
多方骈枝于五藏之情者=多方駢枝于五藏之情者
范县署中寄舍弟墨第书=范縣署中寄舍弟墨第書
夫发于南海而飞于北海=夫發于南海而飛于北海
夫子固有惑志于公伯寮=夫子固有惑志于公伯寮
夫子无意于横目之民乎=夫子無意于橫目之民乎
钢筋混凝土渗渠管制作=鋼筋混凝土滲渠管制作
谷氨酰半胱氨酸甘氨酸=谷氨醯半胱氨酸甘氨酸
谷氨酰半胱氨酸合成酶=谷氨醯半胱氨酸合成酶
谷氨酰甲基酰胺合成酶=谷氨醯甲基醯胺合成酶
过敏性支气管肺曲菌病=過敏性支氣管肺麴菌病
河北联合制药有限公司=河北聯合制藥有限公司
后死者不得与于斯文也=後死者不得與于斯文也
肌动肌球微细纤维系统=肌動肌球微細纖維系統
济宁鲁南公路工程公司=濟甯魯南公路工程公司
集宁师范高等专科学校=集寧師範高等專科學校
济宁市中区阳光大酒店=濟甯市中區陽光大酒店
江宁方山太平天国壁画=江甯方山太平天國壁畫
江宁县汤山镇交通饭店=江甯縣湯山鎮交通飯店
江宁县殷巷乡中心饭店=江甯縣殷巷鄉中心飯店
江西旅游商贸职业学院=江西旅遊商貿職業學院
君子欲讷于言而敏于行=君子欲訥于言而敏於行
辽宁康泰药业有限公司=遼寧康泰藥業有限公司
明乎礼义而陋于知人心=明乎禮義而陋于知人心
明寿宁虎皮庵金汉道人=明壽甯虎皮庵金漢道人
南宁师范高等专科学校=南寧師範高等專科學校
宁得自引深藏于岩穴邪=甯得自引深藏於岩穴邪
宁其生而曳尾于涂中乎=甯其生而曳尾于塗中乎
宁友特种金属纤维制品=甯友特種金屬纖維製品
普宁市南径南洋大酒店=普甯市南徑南洋大酒店
沙伦纳斯贾斯科维休斯=雪倫納斯賈斯科維休斯
山东师范大学历山学院=山東師範大學曆山學院
山西农业大学信息学院=山西農業大學資訊學院
少卿视仆于妻子何如哉=少卿視僕于妻子何如哉
石油炼制技术数据手册=石油煉製技術資料手冊
叔孙武叔语大夫于朝曰=叔孫武叔語大夫于朝曰
四川科创制药有限公司=四川科創制藥有限公司
睢宁县林特产公司饭店=睢甯縣林特產公司飯店
睢宁县睢城镇城北小学=睢甯縣睢城鎮城北小學
天津市宁河县芦台饭店=天津市甯河縣蘆台飯店
托什雷的涡轮电磁炮台=托什雷的渦輪電磁炮台
网游之英俊的死灵法师=網游之英俊的死靈法師
维管植物实验胚胎发生=維管植物實驗胚胎發生
我于古何师而不化之有=我于古何師而不化之有
无宁死于二三子之手乎=無甯死於二三子之手乎
咸平府大觉寺法庆禅师=咸平府大覺寺法慶禪師
新余市城北龙川大酒店=新余市城北龍川大酒店
中北大学信息商务学院=中北大學資訊商務學院
中外围棋经典名局赏析=中外圍棋經典名局賞析
电子专利申请系统用户=電子專利申請系統使用者
福雷斯特帕克血红蛋白=福里斯特派克血紅蛋白
穆斯保尔效应数据索引=穆斯保爾效應資料索引
圣文森特和格林纳丁斯=聖文森特和格林納丁斯群島
牙齿及支持结构的疾患=牙齒及支援結構的疾患
